ác mộng	nightmare,
ác quỷ	devil,
ah	ah,
ai	whom,
ấm áp	warmth,
âm lượng	volume,
âm mưu	conspiracy,
Âm nhạc	music,
âm thanh	sound,
ẩn	hidden,
ẩn giấu	hide,
Anh	English,
anh chị em ruột	sibling,
ảnh chụp	photograph,
anh hùng	hero,
ảnh hưởng	influence,
ánh sáng	light,
ánh sáng mặt trời	sunlight,
anh ta	him,
ân sủng	grace,
an toàn	safely,
ấn tượng	impressive,
ăn xin	beg,
ảo	virtual,
ảo giác	illusion,
áo len	sweater,
áo sơ mi	shirt,
Áo thun	Tshirt,
áp đảo	overwhelming,
áp phích	poster,
Arab	Arab,
axit	acid,
Bà	Mrs,
Bắc	north,
Bác sĩ	doctor,
bác sĩ phẫu thuật	surgeon,
bậc thang	step,
bậc thầy	master,
bài báo	article,
bài báo cáo	report,
bài đăng	post,
bài hát	song,
bài học	lecture,
bài tập	task,
bài tập về nhà	homework,
bám lấy	cling,
bận	busy,
bản án	verdict,
Bạn bè	buddy,
ban bồi thẩm	jury,
Bản chất	essence,
ban cho	grant,
ban đầu	initial,
bán đấu giá	auction,
bản địa	indigenous,
bản đồ	map,
băng	tape,
bạn gái	girlfriend,
bằng cách ấy	thereby,
bằng cách nào đó	somehow,
bảng câu hỏi	questionnaire,
bảng điều khiển	panel,
bằng lòng	consent,
băng qua	across,
bằng sáng chế	patent,
bằng văn bản	written,
bán hàng	sales,
ban hành	enact,
bánh quy	cookie,
bán lẻ	retail,
bàn luận	discuss,
bản năng	instinct,
ban nhạc	band,
bản nháp	draft,
ban phước	bless,
bản thân anh ấy	himself,
bản thân bạn	yourself,
bản thân họ	themselves,
bẩn thỉu	nasty,
bạn trai	boyfriend,
bản văn	text,
bão	hurricane,
báo cáo	reportedly,
báo chí	journalism,
bao gồm	comprise,
Bảo hành	guarantee,
bảo hiểm	insurance,
bạo loạn	riot,
bạo lực	violence,
bão táp	storm,
báo thức	alarm,
bảo tồn	conservation,
bảo trì	maintenance,
bảo vệ	protective,
bát	bowl,
bất bình	spite,
bắt buộc	compel,
bất cứ ai	whoever,
bất cứ điều gì	whatever,
bắt đầu	starter,
bất động sản	estate,
bắt giữ	arrest,
bất kì	any,
bất kỳ ai	anybody,
bắt lấy	catch,
bất ngờ	unexpected,
bất tận	endless,
bầu cử	voting,
bầu trời	sky,
bay	flying,
bay lên	soar,
bày tỏ	express,
bẻ khóa	crack,
bề mặt	surface,
bên	side,
bên cạnh	alongside,
bệnh dịch	epidemic,
bệnh nhân	patient,
Bệnh tiểu đường	diabetes,
bệnh viện	hospital,
bên ngoài	outer,
bến tàu	dock,
bên trong	within,
bền vững	sustainable,
bếp	stove,
bê tông	concrete,
bia	beer,
bị cáo	defendant,
bị cáo buộc	allegedly,
bị cô lập	isolated,
BID	bid,
biển	marine,
biến cố	incident,
biên giới	frontier,
biện hộ	advocate,
biến mất	vanish,
biên soạn	compose,
biết	know,
biệt thự	mansion,
biểu diễn	perform,
biểu hiện	expression,
biểu thị	indicate,
biểu tình	rally,
biểu tượng	icon,
bi kịch	tragic,
bị kích thích	excited,
bí mật	secret,
bình đẳng	equality,
bình luận	comment,
bình minh	dawn,
bình thường	normal,
bình yên	peaceful,
bit	bit,
bít tất	sock,
Bộ	ministry,
bờ biển	shore,
bộ đồ	suit,
bộ dụng cụ	kit,
bơi	pool,
bối cảnh	context,
bơi lội	swimming,
bồi thẩm đoàn	juror,
bởi vì	because,
bộ lạc	tribal,
bỏ lỡ	miss,
bom	bomb,
bốn	four,
bông	cotton,
bong bóng	bubble,
bóng chày	baseball,
bóng đá	soccer,
bóng đèn	bulb,
bông hồng	rose,
bóng râm	shade,
bóng rổ	basketball,
bổ nhiệm	appoint,
bốn mươi	forty,
bồn rửa	sink,
bồn tắm	bath,
bộ phận	department,
bỏ phiếu	vote,
bộ phim	movie,
bỏ qua	skip,
bổ sung	additional,
bộ sưu tập	gallery,
bột	dough,
bột mì	flour,
bộ trưởng	minister,
bỏ túi	pocket,
bộ vi xử lý	processor,
bữa ăn	meal,
bữa tối	dinner,
Bữa trưa	lunch,
bực bội	angry,
bức tượng	statue,
bức vẽ	painting,
bùn	mud,
bụng	belly,
buổi chiều	afternoon,
buổi sáng	morning,
buổi tiệc	party,
buồn bã	upset,
buôn bán	trade,
buồn cười	funny,
búp bê	doll,
bút chì	pencil,
cá	fish,
cabin	cabin,
cách mạng	revolutionary,
cách thức	manner,
các nhà cung cấp	provider,
cá cược	bet,
cả hai	both,
cá hồi	salmon,
cái	piece,
cải cách	reform,
cái cằm	chin,
cái cổ	neck,
cài đặt	installation,
cái đầu	head,
cái đó	that,
cái ghế	chair,
cái gì đó	something,
cái gối	pillow,
cái hộp	box,
cái lồng	cage,
cái mâm	tray,
cái mền	blanket,
cái móc	hook,
cái nĩa	fork,
cái rổ	basket,
cái thìa	spoon,
cải tiến	improved,
cái ví	purse,
cái xô	bucket,
cấm	prohibit,
cá mập	shark,
cảm biến	sensor,
cảm giác	sensation,
cảm hứng	inspiration,
cam kết	commitment,
cảm ơn	thanks,
cảm tạ	thank,
cảm thấy	feel,
cảm thông	sympathy,
cắn	bite,
căn bản	basic,
cân bằng	balanced,
cán bộ	staff,
căn cứ	base,
can đảm	brave,
cân đối	balance,
ca ngợi	praise,
căng ra	stretch,
canh	wing,
cá nhân	individual,
cảnh báo	warn,
cánh buồm	sail,
cánh đồng	field,
cảnh giới	realm,
căn hộ	apartment,
cảnh sát	policeman,
cánh tay	arm,
cân nặng	weight,
cẩn thận	careful,
can thiệp	intervention,
cần thiết	required,
cao	high,
cáo buộc	alleged,
cao cấp	senior,
cao su	rubber,
cấp	rank,
cấp độ	level,
cà phê	coffee,
cập nhật	update,
cấp tiến	progressive,
cấp trên	superior,
carbohydrate	carbohydrate,
carbon	carbon,
cà rốt	carrot,
casino	casino,
cắt tỉa	trim,
cầu	bridge,
câu chuyện	story,
câu đố	puzzle,
câu hỏi	question,
cầu hôn	propose,
câu lạc bộ	club,
câu trả lời	answer,
cấu trúc	structural,
cà vạt	tie,
cá voi	whale,
cây	tree,
cây bụi	bush,
cây bút	pen,
cây cung	bow,
cây kim	needle,
cây rơm	ridge,
cây sồi	oak,
cây thông	pine,
cha	dad,
chắc chắn	inevitably,
chắc chắn rồi	absolutely,
chắc chắn xảy ra	inevitable,
chải	brush,
chậm	slow,
cha mẹ	parental,
chậm rãi	slowly,
chạm tới	reach,
Chân	leg,
chẩn đoán	diagnose,
chàng	guy,
Chanh	lemon,
chân tay	limb,
chấn thương	trauma,
Chào	hey,
chào bán	offering,
chào hỏi	greet,
chào mừng	welcome,
chấp hành	execution,
Chấp nhận	accept,
chấp nhận được	acceptable,
chấp thuận	acceptance,
chặt	chop,
chặt chẽ	tightly,
chất dinh dưỡng	nutrient,
chất độc	toxic,
chất lỏng	liquid,
chất thải	waste,
Châu Âu	European,
cháu ngoại	grandchild,
Châu Phi	African,
chạy	run,
che	cover,
Chế biến	processing,
chế độ	regime,
chế độ nô lệ	slavery,
chèn	insert,
chết	dying,
chế tạo	manufacturing,
chết chìm	drown,
chết người	deadly,
chỉ	solely,
chia	divide,
Chìa khóa	key,
chia sẻ	shared,
chị ấy	she,
chỉ có	only,
chỉ dẫn	instruction,
chỉ đạo	steer,
chỉ định	specify,
chiếc bánh	pie,
chiếm hữu	possession,
chiếm ưu thế	prevail,
chiến binh	warrior,
chiến đấu	battle,
chiến dịch	campaign,
chiến lược	strategy,
chiến thắng	victory,
chiến thuật	tactic,
chiến tranh	war,
chiếu	projection,
chiều dài	length,
chỉ huy	command,
chim	bird,
chín	nine,
chính	major,
chi nhánh	branch,
chính hãng	genuine,
chính no	itself,
chính quyền	government,
chính sách	policy,
chỉnh sửa	edit,
chính thức	officially,
chính trị	politics,
chính trị gia	politician,
chính trực	integrity,
chính xác	accurately,
chi phí	fee,
chỉ thị	indicator,
chi tiết	detailed,
chỉ trích	damn,
chịu	bear,
chịu đựng	endure,
chịu trách nhiệm	responsible,
chó	dog,
chốc lát	moment,
cho đến	till,
chờ đợi	await,
chơi	play,
cholesterol	cholesterol,
chọn	choose,
chống lại	combat,
chớp	bolt,
cho phép	permit,
chớp mắt	blink,
chó sói	wolf,
chỗ trống	blank,
cho vay	lend,
Christian	Christian,
Chú	uncle,
chứa	accommodate,
chữa khỏi	cure,
chữa lành	heal,
chuẩn bị	prepare,
chưa từng có	unprecedented,
chức năng	functional,
chức tổng thống	presidency,
Chức vụ	position,
chủ đề	thread,
Chữ ký	signature,
chùm tia	beam,
chung	general,
chủ ngân hàng	banker,
chứng cớ	evidence,
chung cư	apartment,
chủ nghĩa phân biệt chủng tộc	racism,
chứng minh	demonstrate,
chúng ta	ourselves,
chứng thực	endorse,
chúng tôi	us,
chủ nhà	host,
chủ nhân	owner,
chuỗi	chain,
chương	chapter,
chuồng trại	barn,
chương trình	program,
chuột	mouse,
chủ quyền	sovereignty,
chú thích	note,
Chủ tịch	chairman,
chú ý	attention,
chuyện	affair,
chuyến bay	flight,
chuyên chở	convey,
chuyến đi	trip,
chuyển đổi	conversion,
chuyển động	motion,
chuyến du lịch	tour,
chuyên gia	expert,
chuyển giao	transmit,
chuyên môn	specialty,
chuyên môn hóa	specialize,
chuyên nghiệp	professional,
chuyến thăm	visit,
chủ yếu	mostly,
Cô	Ms,
có ai	somebody,
có ảnh hưởng	influential,
có ảnh hưởng đến	affect,
cổ áo	collar,
cô ấy	herself,
cơ bản	underlying,
cơ bắp	muscle,
cocaine	cocaine,
cỏ dại	weed,
cô dâu	bride,
cô dì	aunt,
cổ điển	classical,
Cơ đốc giáo	Christianity,
cô đơn	lonely,
cổ đông	shareholder,
cố gắng	attempt,
có hiệu lực	valid,
cơ hội	opportunity,
Cổ hủ	oldfashioned,
cởi mở	openly,
cối xay	mill,
có khả năng	ability,
cơ khí	mechanical,
có kinh nghiệm	experienced,
có kỹ năng	skilled,
co lại	shrink,
cô lập	isolation,
có lẽ	presumably,
có liên quan	concerning,
có năng suất	productive,
con bò	bull,
Con bướm	butterfly,
con chuột	rat,
con đập	dam,
con dê	goat,
con đường	path,
Con gái	daughter,
công bằng	equity,
công bố	publish,
công cộng	public,
công dân	civic,
cộng đồng	community,
Công giáo	Catholic,
cống hiến	devote,
công khai	publicity,
công nghệ	technological,
công nghệ cao	hightech,
công nghiệp	industrial,
công nhận	concede,
cộng sự	partner,
công tắc điện	switch,
công thức	formula,
công trinh	works,
công ty	corporate,
công việc	work,
công viên	park,
con khỉ	monkey,
con lợn	pig,
con mèo	cat,
con ngựa	horse,
con ong	bee,
con rắn	snake,
con số	number,
con sông	river,
Con thỏ	rabbit,
con tin	hostage,
con tôm	shrimp,
Con trai	son,
côn trùng	insect,
con vịt	duck,
con voi	elephant,
cổ phần	stock,
cơ quan	organization,
cơ quan lập pháp	legislature,
có sẵn	available,
cơ sở	facility,
cơ sở dữ liệu	database,
cơ sở hạ tầng	infrastructure,
cò súng	trigger,
có tài	talented,
cổ tay	wrist,
có thật không	really,
cơ thể	organism,
có thể truy cập	accessible,
có tính liên quan	involved,
cốt lõi	core,
có ưu thế	dominant,
cố vấn	counselor,
có vẻ	seemingly,
có xu hướng	tend,
có ý nghĩa	meaningful,
có ý thức	conscious,
cũ	old,
cửa	door,
của anh ấy	his,
của bạn	yours,
của chúng ta	our,
của chúng tôi	ours,
của cô ấy	hers,
cửa hàng	store,
của nó	its,
cửa sổ	window,
cửa tiệm	shop,
Cuba	Cuban,
Cục đá	stone,
Cục kẹo	candy,
cư dân	resident,
Cú đánh	stroke,
cụm	cluster,
cứng	stiff,
cung cấp	provided,
củng cố	reinforce,
cung điện	palace,
cũng không	neither,
cũng thế	also,
cùng với nhau	together,
cuộc bầu cử	election,
cuộc đảo chính	coup,
cuộc điều tra	investigation,
cuộc đua	race,
cuộc hẹn	appointment,
cuộc hội thoại	conversation,
Cuộc thi	contest,
cuộc xâm lăng	invasion,
cuộc xung đột	conflict,
cười	laugh,
Cuối cùng	last,
cưới nhau	married,
cuộn	roll,
cường độ	intensity,
cuốn tiểu thuyết	novel,
cụ thể	particular,
cử tri	voter,
cừu	sheep,
cựu chiến binh	veteran,
Cứu giúp	help,
cứu hộ	rescue,
cứu trợ	relief,
Đà	momentum,
đa cảm	emotional,
đặc biệt	distinctive,
đặc điểm	trait,
đã chết	dead,
đã chọn	selected,
đặc quyền	privilege,
đặc tính	feature,
đặc vụ	agent,
đa dạng	variety,
đá hoa	marble,
dải	strip,
đại diện	represent,
đại dương	ocean,
dài hạn	longterm,
đại học	undergraduate,
đại lý	agency,
đại sảnh	hall,
đại sứ	ambassador,
đấm	punch,
đảm bảo	secure,
đám đông	crowd,
đàm luận	discourse,
đám mây	cloud,
đàn anh	elder,
đàn bà	woman,
dân chủ	democracy,
dàn diễn viên	cast,
đắng	bitter,
đang chạy	running,
Đảng Cộng hòa	Republican,
đang đến	coming,
dâng hiến	dedicate,
đàn ghi ta	guitar,
đang hoạt động	active,
dân gian	folk,
đáng kể	substantially,
đáng kinh ngạc	incredible,
đăng nhập	log,
đáng sợ	scary,
đáng tin cậy	reliable,
đáng yêu	lovely,
đánh	hit,
đánh bại	defeat,
đánh dấu	marker,
đánh giá	appreciate,
danh mục đầu tư	portfolio,
danh sách	list,
đánh thức	wake,
danh tiếng	fame,
danh tính	identity,
danh từ	coordinate,
Đánh vần	spell,
Đàn ông	man,
đàn organ	organ,
đàn piano	piano,
dân số	population,
dân sự	civil,
dân thường	civilian,
dân tộc	ethnic,
Đảo	island,
đạo đức	ethical,
đạo Hồi	Islam,
đạo luật	statute,
đảo ngược	reverse,
đào tạo	training,
dap xe	ride,
đa số	majority,
đã sửa	fixed,
đã sử dụng	used,
đất	soil,
đất đai	land,
đạt được	obtain,
đặt nằm	lay,
đặt phòng	reservation,
đất sét	clay,
dấu	hint,
đầu bếp	chef,
đau buồn	grief,
dấu chấm	dot,
đau đầu	headache,
đau đớn	painful,
đầu gối	knee,
dấu hiệu	indication,
đau khổ	suffering,
đau ốm	sick,
đậu phụng	peanut,
đầu ra	outlet,
đấu sĩ	fighter,
đấu thầu	tender,
Đầu tiên	first,
đấu tranh	contend,
đấu trường	arena,
đầu tư	investment,
đầu vào	input,
dấu vết	trace,
đấu với	versus,
dây	cord,
dày đặc	dense,
đầy đủ	adequate,
Đầy màu sắc	colorful,
đẩy nhanh	accelerate,
đầy tham vọng	ambitious,
dây thần kinh	nerve,
dây thừng	rope,
đề cập đến	mention,
đế chế	empire,
dễ chịu	pleasant,
để cho	let,
đề cử	nomination,
đề cương	outline,
dễ dàng	readily,
đếm	count,
đèn	lamp,
đền bù	compensation,
đèn flash	flash,
đề nghị	proposal,
đến hạn	due,
đến nơi	arrive,
đẹp	handsome,
đẹp mắt	spectacular,
dệt	weave,
đề tài	topic,
dễ thương	cute,
đệ trình	submit,
đều đặn	regular,
đề xuất	proposed,
để ý	notice,
đi	go,
đĩa	disc,
địa chỉ nhà	address,
địa điểm	place,
địa hình	terrain,
Địa ngục	hell,
địa phương	local,
đi bộ	walk,
dịch	translation,
dịch bệnh	disease,
di chuyển	move,
dịch vụ	service,
di cư	migration,
đi dạo	walking,
di động	mobile,
điểm	point,
Điểm nổi bật	highlight,
điềm tĩnh	calm,
điện	electrical,
diễn đàn	forum,
điển hình	typical,
Điện thoại	telephone,
diễn viên	actor,
Điều	thing,
điều chỉnh	tune,
diễu hành	parade,
điêu khắc	sculpture,
điều khiển	dictate,
điều kiện	terms,
điều lệ	charter,
điều này	this,
điều phối viên	coordinator,
điều tra	investigate,
điều trị	treatment,
đi lang thang	hike,
đình chỉ	suspend,
đình công	strike,
định dạng	format,
dính máu	bloody,
định mức	norm,
định nghĩa	define,
Đinh ốc	screw,
định vị	locate,
đi qua	passing,
di sản	legacy,
dịu dàng	gentle,
đi văng	couch,
đi vào	enter,
đổ	dump,
doanh nhân	entrepreneur,
đoán trước	anticipate,
dơ bẩn	shit,
đổ bộ	landing,
dốc	steep,
đọc hiểu	reading,
độc lập	independent,
độc nhất	unique,
độc quyền	exclusive,
Độc thân	single,
dọc theo	along,
đồ đạc	stuff,
do đó	thus,
do dự	hesitate,
đói	hunger,
đói bụng	hungry,
đối đầu	confrontation,
đội hình	squad,
đôi khi	sometimes,
đối mặt	face,
đổi mới	innovation,
đối phó	cope,
đời sống	life,
đối tác	counterpart,
đối thủ	rival,
đội trưởng	captain,
đối với	toward,
độ lớn	magnitude,
dọn dẹp	clean,
đồng	bronze,
đông bắc	northeast,
đồng bào	fellow,
dòng chính	mainstream,
động cơ	motive,
Đóng cọc	pile,
động đất	earthquake,
đồng đội	teammate,
đồng hành	companion,
đồng hồ đeo tay	watch,
đơn giản	simple,
đóng lại	shut,
đông lạnh	frozen,
động lực	motivation,
động lực học	dynamics,
Đông Nam	southeast,
đồng nghiệp	colleague,
Đông người	crowded,
đồng phục	uniform,
đồng thời	simultaneously,
đồng tiền	coin,
động vật hoang dã	wildlife,
động viên	motivate,
đồng ý	agree,
đơn thuốc	prescription,
đơn vị	unit,
độ phân giải	resolution,
đổ ra	shed,
đốt	burning,
đồ tạo tác	artifact,
đốt cháy	burn,
đô thị	metropolitan,
độ tin cậy	reliability,
đột ngột	dramatically,
đột nhiên	sudden,
đồ trang sức	jewelry,
đủ	sufficient,
đùa	joke,
đứa bé	baby,
đưa cho	give,
đưa đón	shuttle,
dự án	project,
đứa trẻ	kid,
Đức hạnh	virtue,
đức tin	faith,
dự định	intend,
dự đoán	prediction,
đùi	thigh,
du khách	traveler,
đủ khả năng	afford,
du lịch	tourism,
dữ liệu	data,
đúng	correctly,
Dũng cảm	bold,
dụng cụ	instrument,
dung dịch	solution,
dừng lại	stop,
đuợc	okay,
được cho là	supposedly,
dược phẩm	medicine,
đuôi	tail,
đuổi theo	chase,
đường	way,
đường chân trời	horizon,
đường cong	curve,
đường đi bộ	sidewalk,
đường hầm	tunnel,
đường lái xe	driveway,
đường mòn	trail,
dường như	apparently,
đường phố	street,
đường sắt	railroad,
dù sao	nonetheless,
đủ tiêu chuẩn	qualify,
dự trữ	reserve,
duyên hải	coastal,
Duy Nhất	sole,
duy trì	sustain,
echo	echo,
email	email,
em gái	sister,
em trai	brother,
eo	waist,
fucking	fucking,
gà	chicken,
gạch	brick,
Gan	liver,
gần đây	lately,
gần đó	nearby,
găng tay	glove,
gần hơn	closer,
gắn kết	mount,
gần nhất	closest,
gặp	meet,
gặp gỡ	encounter,
gập lại	fold,
gặp rắc rối	troubled,
gara	garage,
ga tàu	station,
gà tây	turkey,
gật đầu	nod,
gậy	rod,
gây ấn tượng	impress,
gây chán nản cho	discourage,
gây tranh cãi	controversial,
gây trở ngại	interfere,
gây tử vong	fatal,
ghế	seat,
ghế sô pha	sofa,
ghét bỏ	hate,
ghi âm	recording,
ghi bàn	score,
ghi danh	enroll,
ghi lại	record,
ghim	pin,
gì	what,
giá bán	price,
Giá cả	cost,
giác quan	sense,
giả định	supposed,
giá đỡ	rack,
giai đoạn	period,
giải phóng	release,
giải quyết	tackle,
giải thể	dissolve,
giải thích	explain,
giải thưởng	prize,
giải tỏa	relieve,
giảm	reduce,
giảm bớt	ease,
giám đốc	chief,
giảm giá	discount,
giám mục	bishop,
giám sát	surveillance,
giảm thiểu	minimize,
giản dị	casual,
gián điệp	spy,
giận dữ	rage,
giảng bài	teaching,
Giáng Sinh	Christmas,
giảng viên	instructor,
gian hàng	booth,
giành lại	regain,
gian lận	fraud,
Giao dịch	transaction,
giáo dục	educate,
giao hàng	deliver,
Giáo sư	professor,
giao thông	traffic,
giao thức	protocol,
giao tiếp	communication,
giáo viên	teacher,
giáo xứ	parish,
giá rẻ	cheap,
gia súc	cattle,
gia tài	heritage,
giả thuyết	hypothesis,
giá trị	value,
giặt ủi	laundry,
giàu có	wealthy,
giá vé	fare,
giày	shoe,
giết chết	killing,
giết người	murder,
giờ	oclock,
giới hạn	restrict,
giới thiệu	recommend,
giới tính	gender,
giống	resemble,
giống cái	female,
giọng điệu	accent,
giống nhau	identical,
giống nho	grape,
giữ	hold,
giữa	midst,
Giường	bed,
gỗ	timber,
gỡ bỏ	removal,
góc	angle,
gói	package,
gọi món	order,
gợi ý	cue,
golf	golf,
Góp phần	contribute,
gót chân	heel,
gửi	send,
gương	mirror,
ha	ha,
hai	two,
hài hước	humor,
hai lần	twice,
hai mươi	twentieth,
hai phần ba	twothirds,
hải quân	naval,
hàm	jaw,
hăm dọa	threaten,
hạm đội	fleet,
hãm hiếp	rape,
hạn chế	constraint,
hạn chót	deadline,
hang	cave,
hàng đầu	top,
hăng hái	enthusiasm,
hàng hóa	cargo,
hàng năm	annually,
hằng ngày	daily,
hàng tháng	monthly,
hàng tồn kho	inventory,
hàng trăm	hundred,
hàng tuần	weekly,
hàng xóm	neighbor,
hành chính	administrative,
hành động	act,
hạnh kiểm	conduct,
hành lang	hallway,
Hân hoan	delight,
hạnh phúc	happily,
hành tinh	planet,
hành vi	behavioral,
hành xử	behave,
Hàn Quốc	Korean,
hào phóng	generous,
hấp dẫn	fascinating,
hấp thụ	absorb,
hạt	particle,
hầu hết	almost,
hậu quả	consequence,
hậu quả là	consequently,
hậu vệ	defender,
hạ xuống	descend,
hẻm	alley,
hệ sinh thái	ecosystem,
hệ số	factor,
hệ thống	system,
hệ tư tưởng	ideology,
hiếm	rare,
hiện đại	modern,
hiện hành	current,
hiện hữu	exist,
hiện nay	now,
hiên nhà	porch,
hiển nhiên	evident,
hiến pháp	constitution,
hiện ra	emerge,
hiện tại	currently,
hiến tặng	donate,
hiểu biết	understanding,
Hiếu chiến	aggression,
hiểu không	understand,
Hiếu kỳ	curious,
hiệu lực	validity,
hiệu quả	effectiveness,
hiệu suất	performance,
hiệu trưởng	principal,
hiệu ứng	effect,
hình ảnh	picture,
hình chụp	photo,
hình dạng	shape,
hình dung	envision,
hình như	seem,
hình phạt	punishment,
hình thức	form,
hố	pit,
hoa	flower,
hòa bình	peace,
hoặc	either,
hoặc là	or,
hóa đơn	bill,
hóa học	chemistry,
hòa hợp	harmony,
hoang dã	wilderness,
hoảng loạn	panic,
hoàng tộc	royal,
hoàn hảo	perfect,
hoàn thành	accomplishment,
hoàn toàn	altogether,
họa sĩ	painter,
hoạt động	operation,
hoạt hình	cartoon,
học	study,
học bổng	scholarship,
học hỏi	learn,
học tập	academic,
học thuyết	doctrine,
học viên	practitioner,
hộ gia đình	household,
hỏi	ask,
hội chợ	fair,
hội chứng	syndrome,
hội đủ điều kiện	eligible,
Hồi giáo	Muslim,
hội nghị	conference,
hội nghị thượng đỉnh	summit,
hội nhập	integration,
hơi nước	steam,
hội thảo	seminar,
hơi thở	breath,
hối tiếc	regret,
hồi tưởng	recall,
hội viên	member,
hôm nay	today,
hôm qua	yesterday,
hôn	kiss,
hỗn loạn	chaos,
hơn nữa	furthermore,
hôn ước	engagement,
hoocmon	hormone,
hợp chất	compound,
hợp đồng	contract,
hợp lý	logical,
hợp pháp	legally,
hợp tác	collaboration,
hợp tác xã	cooperative,
Hostile	hostile,
hỗ trợ	supportive,
hứa hẹn	promising,
huấn luyện viên	coach,
Huh	huh,
hư hại	damage,
hung ác	cruel,
Hùng biện	rhetoric,
hướng dẫn	instructional,
hướng Tây	west,
hương thơm	scent,
hương vị	flavor,
hút	suck,
hữu cơ	organic,
Hữu ích	helpful,
hữu nghị	friendship,
hủy bỏ	cancel,
huy chương	medal,
huyện	district,
huyền bí	mysterious,
huyền thoại	legend,
hủy hoại	destroy,
hy vọng	hopefully,
in	print,
Internet	Internet,
Iraqi	Iraqi,
Israeli	Israeli,
ít	handful,
ít hơn	fewer,
ít khi	seldom,
ít nhất	least,
jazz	jazz,
kể cả	including,
kế hoạch	scheme,
kéo	pull,
kẹp	clip,
kết cấu	texture,
kết hôn	marry,
kết hợp	combined,
kẻ thù	enemy,
kế tiếp	next,
kết luận	conclude,
kết nối	connect,
kế toán	accounting,
kết quả	outcome,
kết thúc	end,
kể từ	since,
khá	quite,
khác	differently,
khác biệt	distinct,
khắc chạm	carve,
khách	guest,
khách hàng	client,
khách sạn	hotel,
khách thăm quan	visitor,
khắc nghiệt	harsh,
khác nhau	differ,
khả dụng	availability,
khai	declare,
khai mạc	opening,
khái niệm	notion,
khai thác	exploit,
khám phá	uncover,
khả năng	likelihood,
khả năng lãnh đạo	leadership,
kháng cáo	appeal,
khẳng định	assert,
khăn tắm	towel,
khao khát	desire,
khảo sát	survey,
khắp	throughout,
khả thi	possible,
khe	slot,
khéo léo	neat,
khía cạnh	aspect,
khí đốt	gas,
khiêm tốn	modest,
khiển trách	blame,
khiêu vũ	dancing,
khi nào	when,
khinh bỉ	slightly,
Kho	warehouse,
Khóa	lock,
khoa học	science,
khoảng cách	distance,
Khoảng chân không	vacuum,
khoảng lặng	silence,
khoáng sản	mineral,
khoảng thời gian	interval,
kho báu	treasure,
khóc	cry,
khó chịu	uncomfortable,
khốc liệt	fierce,
khỏe	fine,
khoe khoan	boast,
khoe khoang	breeze,
Khỏe mạnh	athletic,
khối	block,
khởi đầu	start,
khởi hành	depart,
khối u	tumor,
khó khăn	hardly,
Không	no,
không ai	nobody,
không bao giờ	ever,
không chắc chắn	uncertain,
không chính thức	informal,
không có	without,
không có gì	nothing,
không công bằng	unfair,
không gian	space,
không giống	unlike,
không khí	air,
khổng lồ	giant,
không phải	not,
Không thể nào	impossible,
không vui	unhappy,
khôn ngoan	wise,
khớp nối	articulate,
khuấy	stir,
khúc côn cầu	hockey,
khúc xương	bone,
khung	frame,
khủng bố	terrorist,
khủng hoảng	crisis,
khủng khiếp	terribly,
khuôn mẫu	stereotype,
khu vực	regional,
khu vực lân cận	neighborhood,
khuyên bảo	advice,
khuyến khích	encouraging,
khuynh hướng	tendency,
khuỷu tay	elbow,
kịch bản	script,
kích động	provoke,
kích thích	stimulate,
kích thích kinh tế	stimulus,
kích thước	size,
kiếm	earn,
kiểm tra	screening,
kiện	sue,
kiên nhẫn	patience,
kiến trúc	architecture,
kiến trúc sư	architect,
kiểu	type,
kim cương	diamond,
kim loại	metal,
kinh dị	horror,
kinh doanh	business,
kinh khủng	horrible,
kinh nghiệm	experience,
kinh tế	economically,
Kinh tế học	economics,
kính thưa	dear,
kỳ dị	weird,
kỳ hạn	term,
kỳ lạ	exotic,
kỹ lưỡng	elaborate,
kỹ năng	skill,
kỷ nguyên	era,
ký tên	sign,
kỳ thị	discrimination,
kỹ thuật	technique,
kỹ thuật viên	technician,
ký ức	memory,
kỳ vọng	expected,
lá	leaf,
lắc	shake,
lạc quan	optimistic,
lại	re,
lái xe	drive,
làm	do,
lẩm bẩm	mutter,
làm bị thương	injure,
lạm dụng	abuse,
làm gián đoạn	interrupt,
làm hại	harm,
làm lạnh	chill,
làm mất tập trung	distract,
làm mềm	soften,
lạm phát	inflation,
làm sao	how,
làm suy yếu	weaken,
làm thẳng	straighten,
làm vui lòng	satisfy,
lăn	rolling,
lân cận	neighboring,
lane	lane,
làng	village,
lãng mạn	romance,
lạnh	cold,
lãnh đạo	leader,
lần nữa	again,
làn sóng	wave,
Lan tràn	spread,
lao động	labor,
lao xuống	plunge,
lấp đầy	fill,
lập kế hoạch	planner,
lập pháp	legislative,
lập trình	programming,
lập trường	stance,
laser	laser,
lật	flip,
lá thư	letter,
lấy	take,
lấy được	derive,
lấy làm tiếc	sorry,
lấy trộm	steal,
lề	margin,
lễ hội	festival,
lễ kỷ niệm	celebration,
lên	up,
lên án	condemn,
lễ nghi	ritual,
lệnh cấm	ban,
leo	climb,
Lễ Tạ ơn	Thanksgiving,
lều	tent,
lịch	calendar,
lịch sử	historically,
liên bang	federal,
liên đoàn	league,
liên doanh	venture,
liên hệ	relate,
liên hiệp	union,
liên kết	associated,
liên minh	alliance,
liên quan	related,
liên tiếp	consecutive,
liên tục	steadily,
Liên Xô	Soviet,
liều	dose,
lính	soldier,
linh hoạt	flexible,
lĩnh hội	perceived,
Linh hồn	soul,
Linh thiêng	sacred,
lí trí	mind,
lọ	jar,
loại	kind,
loại bỏ	eliminate,
loại trừ	exclude,
loạt	series,
lọc	filter,
logic	logic,
lôi	haul,
lời bào chữa	plea,
lối đi	aisle,
lời hứa	promise,
lợi ích	sake,
lời khuyên	counsel,
lời mời	invitation,
lợi nhuận	profit,
lời nói	verbal,
lối sống	lifestyle,
lợi thế	advantage,
lối thoát	exit,
lời thú tội	confession,
lối vào	doorway,
lo lắng	anxious,
lớn	large,
lòng bàn tay	palm,
lòng can đảm	courage,
lòng khoan dung	tolerance,
lông mày	eyebrow,
lông thú	fur,
Lòng tin	trust,
lòng tin chắc	conviction,
lòng trung thành	loyalty,
lòng tự trọng	selfesteem,
lông vũ	feather,
lớn lên	grow,
lộn xộn	mess,
lớp học	class,
lộ trình	route,
lột vỏ	peel,
lũ	flood,
lụa	silk,
lựa chọn	select,
lừa đảo	cheat,
lúa mì	wheat,
luật sư	attorney,
lục địa	continent,
lực lượng	force,
lực sĩ	athlete,
lung lay	swing,
lưỡi	blade,
lương hưu	pension,
lưỡng lự	reluctant,
lương tâm	conscience,
luôn luôn	always,
lượt xem	view,
lưu lượng	flow,
ly	glass,
lý do	reason,
ly hôn	divorce,
lý lịch	background,
lý thuyết	theoretical,
lý tưởng	ideal,
ma	ghost,
mặc	wear,
mặc dù	despite,
mạch	circuit,
màn	screen,
mảng	array,
mang đến	bring,
mạng lưới	net,
mang thai	pregnancy,
mảnh	chunk,
manh mối	clue,
mảnh vụn	debris,
mãn tính	chronic,
mập	fat,
mắt	eye,
mắt cá	ankle,
ma thuật	magic,
mất mát	loss,
mát mẻ	cool,
mất tích	missing,
mặt trời	sun,
màu	color,
màu tím	purple,
màu vàng	yellow,
mẫu vật	sample,
màu xám	gray,
màu xanh da trời	blue,
màu xanh lá	green,
Máy ảnh	camera,
Máy bay	airplane,
máy bay phản lực	jet,
máy bay trực thăng	helicopter,
máy bơm	pump,
máy khoan	drill,
may mắn	fortunately,
máy móc	machine,
máy vi tính	computer,
mẹ	mom,
Mềm dẻo	flexibility,
mềm mại	soft,
mét	meter,
mệt mỏi	fatigue,
mỉa mai	irony,
miền	domain,
miễn dịch	immune,
miếng	fragment,
miếng bò hầm	steak,
miền Nam	south,
miễn phí	free,
miền Tây	western,
miêu tả	portray,
mở	open,
mốc	landmark,
mô hình	model,
mồ hôi	sweat,
môi	lip,
mối đe dọa	threat,
mọi điều	everything,
mời gọi	invite,
mỗi ngày	everyday,
mọi người	everybody,
mới nổi	emerging,
mối quan hệ	relationship,
mối quan ngại	concern,
môi trường	environment,
môi trường sống	habitat,
món ăn	dish,
mông	butt,
mong manh	fragile,
móng tay	nail,
mờ nhạt	faint,
môn học	subject,
món nợ	debt,
môn thể thao	sport,
môn Toán	math,
món tráng miệng	dessert,
mở ra	unfold,
mở rộng	extended,
một	one,
Một lần	once,
một lát sau	later,
một mình	alone,
một ngày nào đó	someday,
một nửa	half,
một phần	partial,
một phần ba	onethird,
một số	several,
mơ tưởng	dream,
một vài nơi	somewhere,
mưa	rain,
mùa đông	winter,
mùa gặt	harvest,
mùa hè	summer,
mua lại	acquisition,
mùa xuân	spring,
mũ bảo hiểm	helmet,
mục	item,
mục đích	aim,
mục lục	catalog,
mục sư	pastor,
Mục tiêu	target,
mũi	nose,
mũi tên	arrow,
Muối	salt,
mười hai	twelve,
mười lăm	fifteen,
mười một	eleven,
muốn	wish,
mỳ ống	pasta,
n	merit,
nạc	lean,
nấm	mushroom,
nắm bắt	capture,
nắm chặt	grip,
Nam giới	male,
năm mươi	fifty,
nắm tay	fist,
nắng	sunny,
nâng cao	raise,
năng động	dynamic,
năng khiếu	gifted,
năng lượng	energy,
năng suất	yield,
nạn nhân	victim,
năn nỉ	insist,
Nắp	lid,
natri	sodium,
nâu	brown,
nấu ăn	cook,
nấu nướng	cooking,
ném	throw,
ném bom	bombing,
nến	candle,
nên kinh tê	economy,
nền tảng	basis,
nền văn hóa	culture,
nền văn minh	civilization,
nếu	if,
nếu không thì	otherwise,
ngã	fall,
ngạc nhiên	surprised,
ngâm	soak,
ngắn	short,
ngăn cấm	forbid,
ngăn chặn	prevent,
ngang nhau	peer,
ngắn gọn	briefly,
ngành	sector,
ngân hàng	banking,
ngành công nghiệp	industry,
ngăn kéo	drawer,
ngân sách	budget,
ngẫu nhiên	random,
ngày	date,
ngày càng	increasingly,
ngày cuối tuần	weekend,
ngày kỷ niệm	anniversary,
ngay lập tức	instantly,
ngày lễ	holiday,
Ngày mai	tomorrow,
nghe	listen,
nghề nghiệp	occupation,
nghèo nàn	poor,
nghệ thuật	artistic,
nghĩ	thought,
nghĩa là	mean,
Nghĩa trang	cemetery,
nghĩa vụ	obligation,
nghiêm khắc	strictly,
nghiêm trọng	severely,
nghiêm túc	seriously,
nghiên cứu	research,
nghiên cứu viên	researcher,
nghiền nát	crush,
nghỉ hưu	retired,
nghìn	thousand,
nghi ngờ	suspicious,
nghỉ ngơi	rest,
ngoài	out,
ngoại giao	diplomatic,
ngoại ô	suburb,
ngoại quốc	foreign,
ngoài ra	besides,
ngoài trời	outdoor,
ngoại trừ	except,
ngói	tile,
ngôi đền	temple,
ngôi sao	star,
ngón chân	toe,
ngớ ngẩn	dumb,
ngọn lửa	flame,
ngôn ngữ	language,
ngón tay	finger,
ngón tay cái	thumb,
ngọt	sweet,
ngủ	asleep,
ngực	chest,
ngũ cốc	grain,
ngư dân	fisherman,
ngưng	cease,
người	person,
người Ấn Độ	Indian,
người Anh	British,
người ăn thịt	predator,
người bán	seller,
người bạn đời	mate,
người bảo trợ	patron,
Người Ba Tư	Persian,
người biên tập	editor,
người biểu diễn	performer,
người bình	pitcher,
người chạy	runner,
người chiến thắng	winner,
người chơi	player,
người chồng	husband,
người cố vấn	mentor,
Người đàn bà góa	widow,
người điều tiết	regulator,
người đọc	reader,
người đóng góp	contributor,
Người Do thái	Jewish,
người dùng	user,
người giám sát	supervisor,
Người Hà Lan	Dutch,
người hầu	servant,
Người Hispanic	Hispanic,
người huấn luyện	trainer,
người Hy Lạp	Greek,
người lái	rider,
người lái xe	driver,
người lớn	adult,
người môi giới	broker,
Người Mỹ	American,
Người Mỹ gốc Phi	AfricanAmerican,
người nào	someone,
Người Nga	Russian,
người nghe	listener,
người ngoài	outsider,
người ngoài hành tinh	alien,
người nhận	recipient,
người nộp thuế	taxpayer,
người nước ngoài	foreigner,
người Pháp	French,
người sống sót	survivor,
người tham gia	participant,
người thu gom	collector,
người tiên phong	pioneer,
người vợ	wife,
người xây dựng	builder,
nguồn	source,
ngưỡng	threshold,
ngưỡng mộ	admire,
nguồn gốc	root,
ngu xuẩn	fool,
nguyên	original,
nguyên đơn	plaintiff,
nguyên nhân	cause,
nguyên tắc	principle,
nguyên tố	prime,
Nguyên tử	nuclear,
nguyên vẹn	intact,
nguy hiểm	hazard,
nhà	home,
nhà bán lẻ	retailer,
nhà bình luận viên	columnist,
nhắc lại	remind,
nhắc nhở	reminder,
nhạc pop	pop,
nhà cung cấp	vendor,
nhà đầu tư	investor,
nhà điều hành	operator,
nhà hàng	restaurant,
nhai	chew,
nhà khoa học	scientist,
nhà kinh tế học	economist,
nhà lập pháp	lawmaker,
nhàm chán	boring,
nhầm lẫn	confuse,
nhãn	tag,
nhận biết	identification,
nhân chứng	witness,
nhận con nuôi	adoption,
nhận định	identify,
nhận được	receive,
nhà ngoại giao	diplomat,
nhanh	rapid,
nhanh chóng	quick,
nhanh hơn	faster,
nhân khẩu học	demographic,
nhân loại	humanity,
nhấn mạnh	stress,
nhăn mặt	frown,
nhận ra	realize,
nhân tạo	artificial,
nhận thức	cognitive,
nhà nước cộng hòa	republican,
nhận vào	admission,
nhân vật	figure,
Nhân viên	employee,
nhân viên bán hàng	clerk,
nhân viên văn phòng	officer,
nhận xét	remark,
nhà ở	residential,
nhấp chuột	click,
nhà phân tích	analyst,
nhà phát triển	developer,
nhà phê bình	critic,
nhập khẩu	import,
nhà sản xuất	producer,
nhát	shy,
nhà tài trợ	donor,
nhà tâm lý học	psychologist,
nhà thầu	contractor,
nhà thiên văn học	astronomer,
nhà thờ	church,
Nhật ký	diary,
nhặt lên	pickup,
nhất quán	consistently,
nhà tranh	cottage,
nhà trị liệu	therapist,
nhà truyền giáo	missionary,
nhất thiết	necessarily,
nhà tù	prison,
nhà văn	writer,
nhà xuất bản	publisher,
nhảy	jump,
nhạy cảm	sensitivity,
nháy mắt	glance,
nhảy vọt	leap,
nhẹ	slight,
nhẹ nhàng	softly,
nhiệm vụ	quest,
nhiên liệu	fuel,
nhiếp ảnh	photography,
nhiếp ảnh gia	photographer,
nhiệt	heat,
nhiệt độ	temperature,
nhiệt đới	tropical,
nhiều	multiple,
nhiều lần	repeatedly,
nhìn	look,
nhìn chằm chằm	gaze,
nhìn nhận	recognize,
nhìn thoáng qua	glimpse,
nhịp	rhythm,
nhổ	spit,
nhỏ bé	tiny,
nhớ lại	remember,
nhôm	aluminum,
như	like,
nhựa	plastic,
nhu cầu	demand,
nhũ hoa	breast,
như là	such,
nhúng	dip,
những người	people,
như nhau	alike,
nhún vai	shrug,
nhượng quyền thương mại	franchise,
niêm phong	seal,
niềm tin	belief,
nổ	burst,
nơi	spot,
nơi ẩn náu	refuge,
nổi bật	striking,
nói chung là	generally,
nói chuyện	talk,
nơi cư trú	residence,
nổi danh	famous,
nơi đến	destination,
Nội địa	interior,
nói dối	lie,
Nội dung	content,
nói lại	repeat,
nơi làm việc	workplace,
nổi loạn	rebel,
nỗi sợ	fear,
nổi tiếng	wellknown,
nông	shallow,
nóng bức	hot,
nông dân	peasant,
nông nghiệp	agriculture,
nông phu	farmer,
nông trại	farm,
nổ tung	explode,
nửa chừng	halfway,
nữa đêm	midnight,
nữa không	anymore,
nực cười	ridiculous,
nụ cười	grin,
nữ diễn viên	actress,
nữ hoàng	queen,
núi	mountain,
Nước	water,
nước cộng hòa	republic,
Nước đá	ice,
nước mắt	tear,
nuôi	feed,
nuôi dưỡng	foster,
nuốt	swallow,
nữ quyền sĩ	feminist,
óc	brain,
ở đâu	wherever,
ở đó	there,
ở gần	near,
ở giữa	middle,
Oh	oh,
ở lại	stay,
ôm	hug,
ổn định	settle,
ống	pipe,
ông bà	grandparent,
ống kính	lens,
ở ngoài	outside,
ôn tập	review,
ở nước ngoài	abroad,
opera	opera,
opt	opt,
ôtô	automobile,
ở trên	beneath,
ôxy	oxygen,
Palestine	Palestinian,
pao	pound,
PC	PC,
phá hoại	ruin,
phải	must,
pha lê	crystal,
phẩm chất	quality,
phẩm giá	dignity,
phạm tội	criminal,
phạm vi	scope,
phần	part,
phân biệt	distinguish,
phản cảm	offensive,
phân chia	division,
phản chiếu	reflect,
phần cứng	hardware,
phán đoán	judgment,
phản đối	opposed,
phanh	brake,
Phản hồi	feedback,
phần kết luận	conclusion,
phân loại	classify,
phần lớn	largely,
phần mềm	software,
phần mộ	grave,
phần nào	somewhat,
phán quyết	ruling,
phân số	fraction,
phần thưởng	reward,
phân tích	analysis,
phần trăm	percentage,
phân tử	molecule,
phản ứng	response,
phao	float,
pháp luật	law,
phá sản	bankruptcy,
phát biểu	speech,
phát đạt	thrive,
Phát hiện	finding,
phát minh	invent,
pha trộn	mixed,
phát sóng	broadcast,
phát triển	developmental,
phẫu thuật	surgery,
phá vỡ	break,
phép ẩn dụ	metaphor,
phép đo	measurement,
phép màu	miracle,
phép tính	calculation,
phía dưới	below,
phía Nam	southern,
phía sau	rear,
phía trên	upper,
phía trong	inside,
phía trước	ahead,
phí bảo hiểm	premium,
Phi công	pilot,
phiền	disturbing,
phiên bản	edition,
phiên họp	session,
phiếu	ballot,
phi hành đoàn	crew,
phi lợi nhuận	nonprofit,
phim ảnh	film,
phim hài	comedy,
phim tài liệu	documentary,
phổ biến	popularity,
phổ biến rộng rãi	widespread,
phổi	lung,
phối hợp	combine,
phóng	launch,
phòng bếp	kitchen,
phong bì	envelope,
Phong cách	style,
phong cảnh	landscape,
phỏng đoán	guess,
phòng học	classroom,
phòng làm việc	bureau,
phòng ngủ	bedroom,
Phòng ngừa	prevention,
phong nha	decent,
phòng thể dục	gym,
phòng thí nghiệm	laboratory,
phòng thủ	defend,
phong trào	movement,
phỏng vấn	interview,
phòng vệ sinh	toilet,
phóng viên	reporter,
phòng xử án	courtroom,
phục hồi chức năng	rehabilitation,
phúc lợi	welfare,
phức tạp	complexity,
phục vụ	serving,
Phù hợp	fit,
phủ nhận	deny,
phước lành	blessing,
Phương bắc	northern,
phương Đông	eastern,
phương hướng	direction,
phương pháp	method,
phương tiện	vehicle,
phương tiện truyền thông	media,
phương trình	equation,
phủ sóng	coverage,
phút	minute,
phụ thuộc	dependent,
phụ tùng	spare,
pizza	pizza,
playoff	playoff,
PM	PM,
pro	pro,
quá	exceed,
quả bóng bay	balloon,
quá cảnh	transit,
quả cầu	sphere,
quá đáng	excessive,
qua đêm	overnight,
quả địa cầu	globe,
quái thú	beast,
quái vật	monster,
quá khứ	past,
qua một bên	aside,
quận	county,
quần áo	clothes,
quán ba	bar,
quan điểm	perspective,
quân đội	military,
Quảng bá	promote,
quảng cáo	promotion,
quang phổ	spectrum,
Quảng trường	square,
quan hệ	relative,
Quần jean	jeans,
quản lý	managing,
quan niệm	conception,
quan sát	observe,
quần short	shorts,
quan tâm	regard,
quản trị	administration,
quan trọng	importantly,
quần vợt	tennis,
quạt	fan,
quá tải	overwhelm,
quà tặng	gift,
quá trình	process,
quấy rối	harassment,
quầy tính tiền	counter,
quê hương	homeland,
quen	familiar,
quét	scan,
quí	precious,
qui định	rule,
quốc gia	nation,
quốc tế	international,
quỹ	fund,
quý bà	lady,
quỹ đạo	orbit,
quy định	regulatory,
quyền công dân	citizenship,
Quyên góp	donation,
quyền hạn	jurisdiction,
quyền lợi	entitle,
quyền lực	powerful,
quyền nuôi con	custody,
quyến rũ	charm,
quyết định	decide,
quỳ xuống	kneel,
ra	forth,
rắc	sprinkle,
rắc rối	trouble,
rác thải	garbage,
radar	radar,
radio	radio,
ra mắt	debut,
răng	tooth,
rao giảng	preach,
ráo nước	drain,
rạp hát	theater,
rất	very,
rất nhiều	greatly,
râu	beard,
render	render,
ribbon	ribbon,
riêng	specific,
riêng tôi	myself,
riêng tư	privacy,
rim	rim,
robot	robot,
roi da	whip,
rời khỏi	leave,
rơi vãi	drop,
Roman	Roman,
Rơm rạ	straw,
rộng	wide,
rộng lớn	vast,
rõ ràng	explicit,
rực rỡ	brilliant,
rủi ro	risky,
rừng	forest,
rừng nhiệt đới	jungle,
ruột	gut,
rượu nho	wine,
rút lui	retreat,
sắc đẹp	beauty,
sạc điện	charge,
sách	book,
sách giáo khoa	textbook,
sai lầm	mistake,
sai rồi	wrong,
sân	yard,
săn bắn	hunt,
sân bay	airport,
sân cỏ	pitch,
sandwich	sandwich,
sáng	bright,
sáng tạo	innovative,
sảnh đợi	lobby,
sân khấu	stage,
sẵn lòng	willing,
sàn nhà	floor,
sản phẩm	product,
sẳn sàng	ready,
sân sau	backyard,
sân vận động	stadium,
sản xuất	production,
sao chép	copy,
sập	slam,
sắp xếp	sort,
sâu	deep,
sau cùng	final,
sau đó	afterward,
say	drunk,
sẽ	will,
sét đánh	lightning,
sexy	sexy,
siêu thị	supermarket,
Sinh	birth,
sinh học	biology,
sinh ra	born,
sinh thái	ecological,
sinh viên	student,
sinh viên năm nhất	freshman,
sneak	sneak,
sọ	skull,
số ba	three,
sơ bộ	preliminary,
sốc	shock,
sơ cấp	primary,
số điện thoại	toll,
sợ hãi	scare,
sở hữu	ownership,
sôi lên	boil,
số lượng	quantity,
số lượng lớn	bulk,
Sớm	soon,
Sơn	paint,
số năm	five,
sống	living,
sống sót	alive,
so sánh	comparable,
sốt	fever,
sổ tay	manual,
sở thích	preference,
streak	streak,
studio	studio,
sửa	repair,
sửa chữa	fix,
sửa đổi	modify,
sự bảo vệ	protection,
sự bức xạ	radiation,
sự bùng nổ	boom,
sự căng thẳng	strain,
sự cần thiết	necessity,
sức chứa	capacity,
sức ép	pressure,
sự chậm trễ	delay,
sự cho phép	permission,
sức hút	attraction,
Sức khỏe	health,
sức mạnh	strength,
Sự công bằng	justice,
sự đánh giá	appreciation,
sự đến	arrival,
sự định hướng	orientation,
Sự đối lập	opposition,
sự đóng góp	contribution,
sự đồng thuận	consensus,
sử dụng	utilize,
sự giống nhau	similarity,
sự hạn chế	restriction,
sự hiện diện	presence,
sự hiểu biết	grasp,
sự hình thành	formation,
sự hy sinh	sacrifice,
suite	suite,
Sự khác biệt	difference,
sự mặc khải	revelation,
sứ mệnh	mission,
sự mong đợi	expectation,
sự mở rộng	extension,
sừng	horn,
sự ngạc nhiên	surprise,
sưng lên	swell,
súng lục	pistol,
súng trường	rifle,
sự nhầm lẫn	confusion,
sương mù	fog,
suốt trong	during,
Súp	soup,
sự phản đối	objection,
sự phấn khích	excitement,
sự phá thai	abortion,
sự phát minh	invention,
sự phát triển	growth,
sự phối hợp	combination,
sự quản lý	management,
sự quyết tâm	determination,
sự sẵn lòng	willingness,
sự sụp đổ	collapse,
sự tập thể dục	fitness,
sự tham dự	attendance,
sự thành công	success,
sự thật	truth,
sự thay đổi	shift,
sự thiên vị	bias,
sự thiếu	shortage,
Sự thông minh	intelligence,
sự tò mò	curiosity,
sự tôn trọng	respect,
sự trừng phạt	sanction,
sư tử	lion,
sự tuân thủ	compliance,
sự tự do	freedom,
sự tự tin	confidence,
sưu tầm	collect,
suy đoán	speculate,
suy giảm	diminish,
Suy nghĩ	thinking,
suy sụp	depressed,
suy thoái kinh tế	recession,
tá	dozen,
tà ác	evil,
tác giả	author,
tách	cup,
tách biệt	separation,
tách rời	separate,
tai	ear,
tài chính	fiscal,
tài khoản	account,
tài liệu	document,
tài liệu tham khảo	reference,
tai nạn	casualty,
tài nguyên	resource,
tại sao	why,
tấm	sheet,
tấm màn	curtain,
tạm ngừng	pause,
tầm nhìn	vision,
tầm quan trọng	importance,
tâm thần	mental,
tạm thời	temporary,
tàn bạo	brutal,
tan chảy	melt,
tấn công	attack,
tăng	boost,
tầng hầm	basement,
tăng lên	rise,
tầng lớp trung lưu	middleclass,
tầng trên	upstairs,
tàn phá	devastating,
tần số	frequency,
tàn tật	disabled,
tạo điều kiện	facilitate,
tạo nên	create,
tạo ra	generate,
tạp chí	magazine,
tập giấy	pad,
tạp hóa	grocery,
tập hợp	assemble,
tập quán	custom,
tập thể	collective,
tập thể dục	workout,
tập tin	file,
tát	slap,
tất cả các	all,
tất cả mọi người	everyone,
tàu	ship,
taxi	cab,
tẩy	remove,
tay áo	sleeve,
Tây Bắc	northwest,
tây nam	southwest,
tệ	badly,
tế bào	cell,
Tên	name,
tế nhị	subtle,
tên lửa	rocket,
tha	excuse,
Thái độ	attitude,
tha lỗi	forgive,
thảm	carpet,
thẩm định	assessment,
thăm dò	exploration,
thăm dò ý kiến	poll,
tham dự	participate,
tham gia	attend,
thám hiểm	expedition,
tham khảo	refer,
tham khảo ý kiến	consult,
thẩm mỹ	aesthetic,
tham nhũng	corruption,
thẩm phán	judge,
thẩm quyền	authority,
thâm thúy	profound,
thám tử	detective,
tham vọng	ambition,
than	coal,
thân cây	stem,
thang	ladder,
tháng Ba	march,
thắng lợi	win,
thang máy	elevator,
Tháng Năm	may,
thẳng thắn	frankly,
thành công	successfully,
thân hình	body,
thanh kiếm	sword,
thành lập	establish,
thanh lịch	elegant,
thanh niên	adolescent,
thần học	theological,
thành phần	composition,
thành phố	municipal,
thành thật	honestly,
thanh tra	inspector,
thành viên	membership,
thân mật	intimate,
than phiền	complain,
thần thánh	divine,
thận trọng	conservative,
thảo luận	discussion,
thảo mộc	herb,
thấp	low,
thập kỷ	decade,
thắp sáng	lighting,
thật	indeed,
thất bại	failure,
thắt chặt	tighten,
tha thứ	tolerate,
thật ngạc nhiên	surprisingly,
thất nghiệp	unemployment,
thất vọng	frustrate,
thấy	deem,
thay đổi	changing,
thay mặt	behalf,
thay thế	replacement,
Thẻ	card,
thế chấp	mortgage,
thể chất	physically,
thể chế	institutional,
thế giới	world,
thế hệ	generation,
thế kỷ	century,
thể loại	genre,
thêm	added,
thêm vào	addition,
theo	according,
theo chiều dọc	vertical,
theo dõi	track,
theo đuổi	pursuit,
theo truyền thống	traditionally,
thế tục	secular,
Thế vận hội	Olympics,
thi	exam,
thích hơn	prefer,
thích hợp	suitable,
thí dụ	example,
Thiên hà	galaxy,
thiên nhiên	nature,
Thiên tài	genius,
Thiên thần	angel,
thiết bị	device,
thiết bị điện tử	electronics,
thiết kế	design,
thiếu niên	youngster,
thiểu số	minority,
thiếu sót	lack,
thị giác	sight,
thi hành	execute,
thính giả	audience,
thính giác	hearing,
thỉnh thoảng	sometime,
thịt	meat,
thịt bò	beef,
thịt heo	pork,
thị trấn	town,
thị trường	market,
thở	breathing,
thỏa hiệp	compromise,
Thoải mái	comfortable,
thỏa thuận	agreement,
thoát khỏi	escape,
thoát ra	exhaust,
thợ cơ khí	mechanic,
thở dài	sigh,
thổi	blow,
thời gian	timing,
thời gian chờ đợi	meantime,
thời gian dài	longtime,
thời gian ngắn	shortterm,
thời tiết	weather,
thời trang	fashion,
thông báo	announcement,
thông điệp	message,
thống đốc	governor,
thống kê	statistical,
thông minh	intelligent,
thống nhất	unite,
thông qua	adopt,
thông suốt	clearly,
thong thả	deliberately,
thông thường	commonly,
thông tin	information,
thợ săn	hunter,
thử	try,
thua	lose,
thừa kế	inherit,
thừa nhận	admit,
thuận lợi	favorable,
thứ ba	third,
thứ bảy	seventh,
thực	real,
thúc đẩy	impulse,
thực đơn	menu,
thực hành	practice,
thực hiện	undertake,
thực ra	actually,
thực sự	truly,
thực tế	realistic,
thực thể	entity,
thức tỉnh	awake,
thực vật	plant,
thủ đô	capital,
thu được	gain,
thuê	rental,
thuê mướn	hire,
thứ hai	secondary,
thu hồi	withdrawal,
thu hút	attract,
thùng	barrel,
thùng đựng hàng	container,
thử nghiệm	experimental,
thung lũng	valley,
thu nhập	revenue,
thuộc địa	colony,
thuộc kinh tế	economic,
thuốc lá	tobacco,
thuốc men	medication,
thuộc tính	attribute,
thuốc uống	drug,
thuộc về	belong,
thuộc về khoa học	scientific,
thường	routinely,
thương gia	merchant,
thương mại	trading,
Thượng nghị viện	Senate,
thưởng ngoạn	contemplate,
thưởng thức	enjoy,
thương trường	marketplace,
Thường xuyên	frequent,
thứ sáu	sixth,
thứ tám	eighth,
thử thách	challenge,
thụ thai	conceive,
thu thập	gathering,
thu thập thông tin	crawl,
thứ tư	fourth,
thủ tục	procedure,
thú vật	animal,
thuyền	boat,
thuyết phục	compelling,
thủy triều	tide,
tia lửa	spark,
tích cực	actively,
tích hợp	integrated,
tịch thu	seize,
tiềm năng	potential,
tiện	convenience,
tiền bạc	money,
tiền boa	tip,
tiền đề	premise,
tiến độ	progress,
tiên đoán	predict,
tiếng cười	laughter,
tiếng Đức	German,
tiếng hát	vocal,
tiếng Nhật	Japanese,
tiếng nói	voice,
tiền gửi	deposit,
tiền mặt	cash,
tiền tệ	currency,
tiền vay	loan,
tiền vệ	quarterback,
tiếp cận	approach,
tiếp nhận	reception,
tiếp theo	following,
tiếp tục	resume,
tiếp xúc	contact,
tiết kiệm	save,
tiết lộ	disclose,
tiết tấu	beat,
tiêu	pepper,
tiểu bang	state,
Tiêu biểu	representative,
Tiêu chuẩn	standard,
tiêu cực	negative,
tiêu đề	headline,
tiêu điểm	focus,
tiêu dùng	consumption,
tiểu sử	biography,
tiêu tan	scatter,
tỉ lệ	ratio,
tim	heart,
Tìm kiếm	search,
tìm thấy	find,
tin	believe,
tin đồn	rumor,
tín dụng	credit,
tỉnh	province,
tính cách	character,
tình cảm	emotionally,
tính chính xác	accuracy,
tình cờ gặp	stumble,
tình dục	sexuality,
tình hình	situation,
tình huống	circumstance,
tín hiệu	signal,
tính không chắc chắn	uncertainty,
tình nguyện	voluntary,
tinh tế	delicate,
tinh thần	mentally,
tính toán	calculate,
tình trạng khó xử	dilemma,
tinh vi	sophisticated,
Tin tức	news,
tỉ trọng	density,
tivi	television,
tổ	nest,
tòa án	court,
toàn bộ	total,
toàn cầu	global,
Tòa nhà	building,
toán học	mathematics,
toàn quốc	nationwide,
toàn thể	whole,
toàn thời gian	fulltime,
tỏa sáng	shine,
toa xe	wagon,
tóc	hair,
tố cáo	accusation,
tốc độ	speed,
tổ chức	organized,
tóc vàng	blond,
tổ hợp	assembly,
tội	sin,
tội ác	crime,
Tối cao	Supreme,
tối đa	maximum,
tội lỗi	guilt,
tối nay	tonight,
tội phạm	offender,
tối thiểu	minimum,
tóm lược	summary,
Tổng	gross,
tổng hợp	sum,
tôn giáo	religion,
tổng thể	overall,
tổng thống	presidential,
tốn kém	costly,
tồn tại	persist,
tốt	best,
tốt đẹp	nice,
tốt hơn	better,
tổ tiên	ancestor,
to tiếng	loud,
tốt nghiệp	graduation,
trả	pay,
trách nhiệm	responsibility,
trách nhiệm giải trình	accountability,
trách nhiệm pháp lý	liability,
trại	camp,
trái bóng	ball,
trái cam	orange,
trái cây	fruit,
trái chuối	banana,
trái đất	earth,
trailer	trailer,
trải qua	undergo,
trả lời	respond,
trán	forehead,
trận đánh	fighting,
trận đấu	match,
trang	page,
Trang bị	equip,
trang điểm	makeup,
trang phục	outfit,
trạng thái	status,
Trang thiết bị	equipment,
trang trại	ranch,
trang trí	decorate,
tránh	avoid,
tranh giành	scramble,
tranh luận	debate,
Tranh sơn dầu	canvas,
trần truồng	naked,
trao đổi	exchange,
trẻ	young,
trên	atop,
trên toàn thế giới	worldwide,
treo	hang,
trẻ sơ sinh	infant,
tri ân	grateful,
Trích dẫn	quote,
triển khai	deploy,
triển lãm	exhibit,
triệt để	thoroughly,
triết học	philosophical,
triệu	million,
trình diễn	demonstration,
trình độ	degree,
trình tự	sequence,
trí tuệ	intellectual,
triumph	triumph,
tro	ash,
trợ cấp	subsidy,
trò chơi	game,
trôi dạt	drift,
trở lại	back,
trợ lý	aide,
tròn	round,
trở nên	become,
trống	drum,
trở ngại	obstacle,
trong khi	while,
trong khi đó	meanwhile,
trong khoảng	about,
trong nước	domestic,
trong sáng	clear,
trong số	among,
trớ trêu thay	ironically,
trở về	return,
trưa	noon,
trực tiếp	directly,
Trực tuyến	online,
trừ khi	unless,
trứng	egg,
Trung bình	medium,
Trung bình cộng	average,
trừng phạt	punish,
Trung Quốc	Chinese,
Trung tâm	central,
trung tâm mua sắm	mall,
trung tâm thành phố	downtown,
trung thành	loyal,
Trung tính	neutral,
trước	prior,
trước đây	former,
trước kia	formerly,
trước mặt	front,
trường đại học	university,
trường học	school,
trường hợp	case,
trường hợp khẩn cấp	emergency,
trượt	slide,
trượt tuyết	ski,
trừu tượng	abstract,
truy cập	access,
truyền tải	transmission,
truyền thống	tradition,
truy tố	prosecution,
truy vấn	persuade,
từ	word,
tuần	week,
tuân theo	comply,
tuần tra	patrol,
từ chối	denial,
từ chức	resign,
tuck	tuck,
tức thời	instant,
tự do	freely,
tự động	automatic,
tự hào	proud,
tụ họp	gather,
túi	bag,
tủ lạnh	refrigerator,
tự ngã	ego,
tung lên	bounce,
tư nhân	privately,
tự nhiên	native,
tươi	fresh,
tuổi tác	age,
Tường	wall,
tượng đài	monument,
tương đối	relatively,
tương đương	equivalent,
Tương lai	future,
tương phản	contrast,
tương quan	correlation,
tương tác	interact,
tường thuật	narrative,
tượng trưng	symbolic,
tương tự	likewise,
tưởng tượng	imagine,
tương ứng	respectively,
tư pháp	judicial,
tủ quần áo	closet,
từ thiện	charity,
từ tính	magnetic,
tự trị	autonomy,
tư vấn	counseling,
tử vong	mortality,
Tùy chọn	option,
tuyên bố	proclaim,
tuyển dụng	recruit,
tuyệt	sheer,
tuyệt diệu	fantastic,
tuyệt đối	absolute,
tuyệt quá	great,
Tuyệt vời	wonderful,
tuyệt vọng	desperately,
Tuy nhiên	however,
tùy theo	depend,
TV	TV,
tỷ	billion,
tỷ lệ	odds,
uh	uh,
ứng cử viên	nominee,
ứng dụng	application,
ủng hộ	favor,
ung thư	cancer,
ứng viên	candidate,
United	United,
ước tính	estimated,
uống	drinking,
ủy ban	committee,
ủy nhiệm	mandate,
uy tín	credibility,
ủy viên	commissioner,
và	and,
va chạm	impact,
vách đá	cliff,
vắcxin	vaccine,
vải	cloth,
vai trò	role,
van	van,
văn chương	literature,
vận chuyển	transport,
vẫn còn	remain,
vấn đề	matter,
vận dụng	manipulate,
vàng	golden,
vận hành	operate,
văn hoá	cultural,
văn phòng	office,
vào	into,
vật	object,
vật chất	material,
vật lý	physics,
vật nuôi	pet,
váy	skirt,
vây quanh	surround,
vé	ticket,
về cơ bản	basically,
vẻ đẹp	beauty,
vẽ tranh	draw,
vết thương	wound,
vết trầy	scratch,
vĩ đại nhất	greatest,
video	video,
việc làm	job,
viện bảo tàng	museum,
Viên thuốc	pill,
viện trợ	aid,
viết	writing,
vi khuẩn	bacteria,
vinh quang	glory,
vitamin	vitamin,
vì thế	hence,
vị trí	placement,
vợ chồng	couple,
vô cùng	incredibly,
vô danh	anonymous,
Vô gia cư	homeless,
vô hình	invisible,
vợ hoặc chồng	spouse,
vội	hurry,
vòi hoa sen	shower,
vội vã	rush,
vồ lấy	grab,
vốn có	inherent,
vòng	lap,
vòng lặp	loop,
vòng tròn	circle,
vỗ vỗ	pat,
vừa đủ	barely,
vừa lòng	pleased,
vừa phải	moderate,
vụ bê bối	scandal,
vũ công	dancer,
vui lên	cheer,
vui lòng	pleasure,
vui mừng	happy,
vui vẻ	fun,
vũ khí	weapon,
vùng	zone,
vững chắc	firmly,
vụ nổ	blast,
vườn	garden,
Vương quốc	kingdom,
vượt qua	cross,
vượt ra ngoài	beyond,
vv	etc,
web	web,
wow	wow,
xa	far,
xà bông	soap,
xác nhận	confirm,
xác thịt	flesh,
xã hội	socially,
xâm chiếm	invade,
xăng	gasoline,
xa nhau	apart,
xáo trộn	disturb,
xấu	bad,
xấu hổ	embarrassed,
xấu xí	ugly,
xây dựng	construction,
xây dựng lại	rebuild,
xảy ra	occur,
xe buýt	bus,
Xe đạp	bicycle,
xe đẩy	cart,
xe hơi	car,
xe lăn	wheelchair,
xe lửa	train,
xem	see,
xem xét	examine,
Xêp hạng	rating,
xe tải	truck,
xe tăng	tank,
xin lỗi	apology,
xin thề	swear,
xin vui lòng	please,
Xịt nước	spray,
xô	poke,
xoắn	twist,
xoay	turn,
xưa	ancient,
xuất hiện	appearance,
xuất khẩu	export,
xử lý	handle,
xung	pulse,
xung quanh	surrounding,
xưởng	workshop,
xương sống	spine,
xương sườn	rib,
xuyên qua	through,
ý định	intent,
yeah	yeah,
Yên nghỉ	rip,
Yên tĩnh	quiet,
yêu	love,
yêu cầu	inquiry,
yếu đuối	weakness,
yêu thích	favorite,
Y khoa	medical,
ý kiến	idea,
Ý nghĩa	meaning,
y tá	nurse,
ý thức	consciousness,
ý thức hệ	ideological,
