a	một,
ability	có khả năng,
able	có thể,
abortion	sự phá thai,
about	trong khoảng,
above	ở trên,
abroad	ở nước ngoài,
absolute	tuyệt đối,
absolutely	chắc chắn rồi,
absorb	hấp thụ,
abstract	trừu tượng,
abuse	lạm dụng,
academic	học tập,
accelerate	đẩy nhanh,
accent	giọng điệu,
accept	Chấp nhận,
acceptable	chấp nhận được,
acceptance	chấp thuận,
access	truy cập,
accessible	có thể truy cập,
accident	Tai nạn,
accommodate	chứa,
accomplishment	hoàn thành,
according	theo,
account	tài khoản,
accountability	trách nhiệm giải trình,
accounting	kế toán,
accuracy	tính chính xác,
accurately	chính xác,
accusation	tố cáo,
achieve	Hoàn thành,
acid	axit,
acknowledge	công nhận,
acquisition	mua lại,
across	băng qua,
act	hành động,
action	hoạt động,
active	đang hoạt động,
actively	tích cực,
activity	Hoạt động,
actor	diễn viên,
actress	nữ diễn viên,
actual	thực tế,
actually	thực ra,
ad	quảng cáo,
add	thêm vào,
added	thêm,
addition	thêm vào,
additional	bổ sung,
address	địa chỉ nhà,
adequate	đầy đủ,
adjustment	điều chỉnh,
administer	quản lý,
administration	quản trị,
administrative	hành chính,
admire	ngưỡng mộ,
admission	nhận vào,
admit	thừa nhận,
adolescent	thanh niên,
adopt	thông qua,
adoption	nhận con nuôi,
adult	người lớn,
advantage	lợi thế,
advice	khuyên bảo,
advocate	biện hộ,
aesthetic	thẩm mỹ,
affair	chuyện,
affect	có ảnh hưởng đến,
afford	đủ khả năng,
afraid	sợ,
African	Châu Phi,
AfricanAmerican	Người Mỹ gốc Phi,
after	sau,
afternoon	buổi chiều,
afterward	sau đó,
again	lần nữa,
against	chống lại,
age	tuổi tác,
agency	đại lý,
agent	đặc vụ,
aggression	Hiếu chiến,
ago	trước,
agree	đồng ý,
agreement	thỏa thuận,
agricultural	nông nghiệp,
agriculture	nông nghiệp,
ah	ah,
ahead	phía trước,
aid	viện trợ,
aide	trợ lý,
aim	mục đích,
air	không khí,
airplane	Máy bay,
airport	sân bay,
aisle	lối đi,
alarm	báo thức,
alien	người ngoài hành tinh,
alike	như nhau,
alive	sống sót,
all	tất cả các,
allegation	cáo buộc,
alleged	cáo buộc,
allegedly	bị cáo buộc,
alley	hẻm,
alliance	liên minh,
allow	cho phép,
almost	hầu hết,
alone	một mình,
along	dọc theo,
alongside	bên cạnh,
already	đã,
also	cũng thế,
although	mặc dù,
altogether	hoàn toàn,
aluminum	nhôm,
always	luôn luôn,
AM	LÀ,
ambassador	đại sứ,
ambition	tham vọng,
ambitious	đầy tham vọng,
amendment	sửa đổi,
American	Người Mỹ,
amid	giữa,
among	trong số,
amount	số lượng,
analysis	phân tích,
analyst	nhà phân tích,
ancestor	tổ tiên,
ancient	xưa,
and	và,
angel	Thiên thần,
angle	góc,
angry	bực bội,
animal	thú vật,
ankle	mắt cá,
anniversary	ngày kỷ niệm,
announce	tuyên bố,
announcement	thông báo,
annual	hàng năm,
annually	hàng năm,
anonymous	vô danh,
another	khác,
answer	câu trả lời,
anticipate	đoán trước,
anxious	lo lắng,
any	bất kì,
anybody	bất kỳ ai,
anymore	nữa không,
anyone	bất kỳ ai,
anything	bất cứ điều gì,
anyway	dù sao,
anywhere	ở đâu,
apart	xa nhau,
apartment	căn hộ,
apologize	xin lỗi,
apology	xin lỗi,
apparently	dường như,
appeal	kháng cáo,
appear	xuất hiện,
appearance	xuất hiện,
application	ứng dụng,
apply	ứng dụng,
appoint	bổ nhiệm,
appointment	cuộc hẹn,
appreciate	đánh giá,
appreciation	sự đánh giá,
approach	tiếp cận,
appropriate	thích hợp,
Arab	Arab,
architect	kiến trúc sư,
architecture	kiến trúc,
area	khu vực,
arena	đấu trường,
argue	tranh luận,
argument	tranh luận,
arm	cánh tay,
army	quân đội,
around	xung quanh,
array	mảng,
arrest	bắt giữ,
arrival	sự đến,
arrive	đến nơi,
arrow	mũi tên,
art	nghệ thuật,
article	bài báo,
articulate	khớp nối,
artifact	đồ tạo tác,
artificial	nhân tạo,
artist	họa sĩ,
artistic	nghệ thuật,
as	như,
ash	tro,
aside	qua một bên,
ask	hỏi,
asleep	ngủ,
aspect	khía cạnh,
ass	mông,
assemble	tập hợp,
assembly	tổ hợp,
assert	khẳng định,
assessment	thẩm định,
assignment	nhiệm vụ,
associate	liên kết,
associated	liên kết,
assume	giả định,
astronomer	nhà thiên văn học,
at	tại,
athlete	lực sĩ,
athletic	Khỏe mạnh,
atop	trên,
attack	tấn công,
attempt	cố gắng,
attend	tham gia,
attendance	sự tham dự,
attention	chú ý,
attitude	Thái độ,
attorney	luật sư,
attract	thu hút,
attraction	sức hút,
attribute	thuộc tính,
auction	bán đấu giá,
audience	thính giả,
aunt	cô dì,
author	tác giả,
authority	thẩm quyền,
authorize	cho phép,
auto	Tự động,
automatic	tự động,
automatically	tự động,
automobile	ôtô,
autonomy	tự trị,
availability	khả dụng,
available	có sẵn,
average	Trung bình cộng,
avoid	tránh,
await	chờ đợi,
awake	thức tỉnh,
award	giải thưởng,
aware	ý thức,
away	xa,
awful	kinh khủng,
baby	đứa bé,
back	trở lại,
background	lý lịch,
backyard	sân sau,
bacteria	vi khuẩn,
bad	xấu,
badly	tệ,
bag	túi,
balance	cân đối,
balanced	cân bằng,
ball	trái bóng,
balloon	quả bóng bay,
ballot	phiếu,
ban	lệnh cấm,
banana	trái chuối,
band	ban nhạc,
bank	ngân hàng,
banker	chủ ngân hàng,
banking	ngân hàng,
bankruptcy	phá sản,
bar	quán ba,
bare	trần,
barely	vừa đủ,
barn	chuồng trại,
barrel	thùng,
base	căn cứ,
baseball	bóng chày,
basement	tầng hầm,
basic	căn bản,
basically	về cơ bản,
basis	nền tảng,
basket	cái rổ,
basketball	bóng rổ,
bat	gậy,
bath	bồn tắm,
battery	ắc quy,
battle	chiến đấu,
bay	bay,
beach	bờ biển,
beam	chùm tia,
bear	chịu,
beard	râu,
beast	quái thú,
beat	tiết tấu,
beautiful	đẹp,
beauty	sắc đẹp,
because	bởi vì,
become	trở nên,
bed	Giường,
bedroom	phòng ngủ,
bee	con ong,
beef	thịt bò,
beer	bia,
before	trước,
beg	ăn xin,
begin	bắt đầu,
beginning	bắt đầu,
behalf	thay mặt,
behave	hành xử,
behavior	hành vi,
behavioral	hành vi,
behind	phía sau,
being	đang,
belief	niềm tin,
believe	tin,
belly	bụng,
belong	thuộc về,
below	phía dưới,
beneath	ở trên,
benefit	lợi ích,
beside	bên cạnh,
besides	ngoài ra,
best	tốt,
bet	cá cược,
better	tốt hơn,
between	giữa,
beyond	vượt ra ngoài,
bias	sự thiên vị,
bicycle	Xe đạp,
bid	BID,
big	lớn,
bill	hóa đơn,
billion	tỷ,
biography	tiểu sử,
biology	sinh học,
bird	chim,
birth	Sinh,
bishop	giám mục,
bit	bit,
bite	cắn,
bitter	đắng,
black	đen,
blade	lưỡi,
blame	khiển trách,
blank	chỗ trống,
blanket	cái mền,
blast	vụ nổ,
blend	trộn,
bless	ban phước,
blessing	phước lành,
blink	chớp mắt,
block	khối,
blond	tóc vàng,
blood	máu,
bloody	dính máu,
blow	thổi,
blue	màu xanh da trời,
board	bảng,
boast	khoe khoan,
boat	thuyền,
body	thân hình,
boil	sôi lên,
bold	Dũng cảm,
bolt	chớp,
bomb	bom,
bombing	ném bom,
bond	liên kết,
bone	khúc xương,
bonus	thưởng,
book	sách,
boom	sự bùng nổ,
boost	tăng,
booth	gian hàng,
border	biên giới,
boring	nhàm chán,
born	sinh ra,
borrow	vay,
both	cả hai,
bottle	chai,
bottom	đáy,
bounce	tung lên,
bow	cây cung,
bowl	bát,
box	cái hộp,
boy	con trai,
boyfriend	bạn trai,
brain	óc,
brake	phanh,
branch	chi nhánh,
brave	can đảm,
break	phá vỡ,
breast	nhũ hoa,
breath	hơi thở,
breathing	thở,
breeze	khoe khoang,
brick	gạch,
bride	cô dâu,
bridge	cầu,
briefly	ngắn gọn,
bright	sáng,
brilliant	rực rỡ,
bring	mang đến,
British	người Anh,
broad	rộng lớn,
broadcast	phát sóng,
broker	người môi giới,
bronze	đồng,
brother	em trai,
brown	nâu,
brush	chải,
brutal	tàn bạo,
bubble	bong bóng,
bucket	cái xô,
buddy	Bạn bè,
budget	ngân sách,
bug	lỗi,
build	xây dựng,
builder	người xây dựng,
building	Tòa nhà,
bulb	bóng đèn,
bulk	số lượng lớn,
bull	con bò,
bureau	phòng làm việc,
burn	đốt cháy,
burning	đốt,
burst	nổ,
bus	xe buýt,
bush	cây bụi,
business	kinh doanh,
businessman	doanh nhân,
busy	bận,
but	nhưng,
butt	mông,
butterfly	Con bướm,
buy	mua,
by	bởi,
cab	taxi,
cabin	cabin,
cage	cái lồng,
calculate	tính toán,
calculation	phép tính,
calendar	lịch,
call	gọi,
calm	điềm tĩnh,
camera	Máy ảnh,
camp	trại,
campaign	chiến dịch,
can	có thể,
cancel	hủy bỏ,
cancer	ung thư,
candidate	ứng viên,
candle	nến,
candy	Cục kẹo,
canvas	Tranh sơn dầu,
capacity	sức chứa,
capital	thủ đô,
captain	đội trưởng,
capture	nắm bắt,
car	xe hơi,
carbohydrate	carbohydrate,
carbon	carbon,
card	Thẻ,
care	quan tâm,
career	nghề nghiệp,
careful	cẩn thận,
carefully	cẩn thận,
cargo	hàng hóa,
carpet	thảm,
carrier	vận chuyển,
carrot	cà rốt,
carry	mang,
cart	xe đẩy,
cartoon	hoạt hình,
carve	khắc chạm,
case	trường hợp,
cash	tiền mặt,
casino	casino,
cast	dàn diễn viên,
casual	giản dị,
casualty	tai nạn,
cat	con mèo,
catalog	mục lục,
catch	bắt lấy,
category	thể loại,
Catholic	Công giáo,
cattle	gia súc,
cause	nguyên nhân,
cave	hang,
cease	ngưng,
celebration	lễ kỷ niệm,
cell	tế bào,
cemetery	Nghĩa trang,
center	Trung tâm,
central	Trung tâm,
century	thế kỷ,
certain	chắc chắn,
certainly	chắc chắn,
chain	chuỗi,
chair	cái ghế,
chairman	Chủ tịch,
challenge	thử thách,
chance	cơ hội,
change	thay đổi,
changing	thay đổi,
chaos	hỗn loạn,
chapter	chương,
character	tính cách,
charge	sạc điện,
charity	từ thiện,
charm	quyến rũ,
charter	điều lệ,
chase	đuổi theo,
cheap	giá rẻ,
cheat	lừa đảo,
check	kiểm tra,
cheer	vui lên,
chef	đầu bếp,
chemistry	hóa học,
chest	ngực,
chew	nhai,
chicken	gà,
chief	giám đốc,
child	đứa trẻ,
chill	làm lạnh,
chin	cái cằm,
Chinese	Trung Quốc,
choice	lựa chọn,
cholesterol	cholesterol,
choose	chọn,
chop	chặt,
Christian	Christian,
Christianity	Cơ đốc giáo,
Christmas	Giáng Sinh,
chronic	mãn tính,
chunk	mảnh,
church	nhà thờ,
circle	vòng tròn,
circuit	mạch,
circumstance	tình huống,
cite	trích dẫn,
citizen	công dân,
citizenship	quyền công dân,
city	thành phố,
civic	công dân,
civil	dân sự,
civilian	dân thường,
civilization	nền văn minh,
claim	yêu cầu,
class	lớp học,
classical	cổ điển,
classify	phân loại,
classroom	phòng học,
clay	đất sét,
clean	dọn dẹp,
clear	trong sáng,
clearly	thông suốt,
clerk	nhân viên bán hàng,
click	nhấp chuột,
client	khách hàng,
cliff	vách đá,
climb	leo,
cling	bám lấy,
clip	kẹp,
close	gần,
closed	đóng,
closer	gần hơn,
closest	gần nhất,
closet	tủ quần áo,
cloth	vải,
clothes	quần áo,
cloud	đám mây,
club	câu lạc bộ,
clue	manh mối,
cluster	cụm,
coach	huấn luyện viên,
coal	than,
coastal	duyên hải,
cocaine	cocaine,
code	mã,
coffee	cà phê,
cognitive	nhận thức,
coin	đồng tiền,
cold	lạnh,
collaboration	hợp tác,
collapse	sự sụp đổ,
collar	cổ áo,
colleague	đồng nghiệp,
collect	sưu tầm,
collection	bộ sưu tập,
collective	tập thể,
collector	người thu gom,
college	trường đại học,
colonial	thuộc địa,
colony	thuộc địa,
color	màu,
colorful	Đầy màu sắc,
columnist	nhà bình luận viên,
combat	chống lại,
combination	sự phối hợp,
combine	phối hợp,
combined	kết hợp,
come	đến,
comedy	phim hài,
comfortable	Thoải mái,
coming	đang đến,
command	chỉ huy,
comment	bình luận,
commercial	thương mại,
commissioner	ủy viên,
commit	cam kết,
commitment	cam kết,
committee	ủy ban,
commodity	hàng hóa,
common	chung,
commonly	thông thường,
communication	giao tiếp,
community	cộng đồng,
companion	đồng hành,
company	Công ty,
comparable	so sánh,
compare	so sánh,
compel	bắt buộc,
compelling	thuyết phục,
compensation	đền bù,
competition	cuộc thi,
competitor	đối thủ,
complain	than phiền,
complete	hoàn thành,
completely	hoàn toàn,
complex	phức tạp,
complexity	phức tạp,
compliance	sự tuân thủ,
comply	tuân theo,
component	thành phần,
compose	biên soạn,
composition	thành phần,
compound	hợp chất,
comprise	bao gồm,
compromise	thỏa hiệp,
computer	máy vi tính,
concede	công nhận,
conceive	thụ thai,
concept	khái niệm,
conception	quan niệm,
concern	mối quan ngại,
concerned	liên quan,
concerning	có liên quan,
conclude	kết luận,
conclusion	phần kết luận,
concrete	bê tông,
condemn	lên án,
condition	điều kiện,
conduct	hạnh kiểm,
conference	hội nghị,
confess	xưng,
confession	lời thú tội,
confidence	sự tự tin,
confirm	xác nhận,
conflict	cuộc xung đột,
confrontation	đối đầu,
confuse	nhầm lẫn,
confusion	sự nhầm lẫn,
Congress	Hội nghị,
connect	kết nối,
connection	kết nối,
conscience	lương tâm,
conscious	có ý thức,
consciousness	ý thức,
consecutive	liên tiếp,
consensus	sự đồng thuận,
consent	bằng lòng,
consequence	hậu quả,
consequently	hậu quả là,
conservation	bảo tồn,
conservative	thận trọng,
consider	xem xét,
considerably	đáng kể,
consistently	nhất quán,
conspiracy	âm mưu,
constitution	hiến pháp,
constraint	hạn chế,
construction	xây dựng,
consult	tham khảo ý kiến,
consume	tiêu dùng,
consumer	khách hàng,
consumption	tiêu dùng,
contact	tiếp xúc,
contain	chứa,
container	thùng đựng hàng,
contemplate	thưởng ngoạn,
contemporary	đồng thời,
contend	đấu tranh,
content	Nội dung,
contest	Cuộc thi,
context	bối cảnh,
continent	lục địa,
continue	tiếp tục,
continued	tiếp tục,
continuing	tiếp tục,
continuous	liên tiếp,
contract	hợp đồng,
contractor	nhà thầu,
contrast	tương phản,
contribute	Góp phần,
contribution	sự đóng góp,
contributor	người đóng góp,
control	điều khiển,
controversial	gây tranh cãi,
convenience	tiện,
conversation	cuộc hội thoại,
conversion	chuyển đổi,
convey	chuyên chở,
convict	tù nhân,
conviction	lòng tin chắc,
convinced	thuyết phục,
cook	nấu ăn,
cookie	bánh quy,
cooking	nấu nướng,
cool	mát mẻ,
cooperate	hợp tác,
cooperative	hợp tác xã,
coordinate	danh từ,
coordinator	điều phối viên,
cope	đối phó,
copy	sao chép,
cord	dây,
core	cốt lõi,
corner	góc,
corporate	công ty,
correct	chính xác,
correctly	đúng,
correlation	tương quan,
corridor	hành lang,
corruption	tham nhũng,
cost	Giá cả,
costly	tốn kém,
costume	trang phục,
cottage	nhà tranh,
cotton	bông,
couch	đi văng,
could	có thể,
counsel	lời khuyên,
counseling	tư vấn,
counselor	cố vấn,
count	đếm,
counter	quầy tính tiền,
counterpart	đối tác,
country	Quốc gia,
county	quận,
coup	cuộc đảo chính,
couple	vợ chồng,
courage	lòng can đảm,
course	khóa học,
court	tòa án,
courtroom	phòng xử án,
cover	che,
coverage	phủ sóng,
cow	bò,
crack	bẻ khóa,
crash	tai nạn,
crawl	thu thập thông tin,
crazy	khùng,
create	tạo nên,
creativity	sáng tạo,
credibility	uy tín,
credit	tín dụng,
crew	phi hành đoàn,
crime	tội ác,
criminal	phạm tội,
crisis	khủng hoảng,
critic	nhà phê bình,
critical	chỉ trích,
cross	vượt qua,
crowd	đám đông,
crowded	Đông người,
cruel	hung ác,
cruise	du lịch,
crush	nghiền nát,
cry	khóc,
crystal	pha lê,
Cuban	Cuba,
cue	gợi ý,
cultural	văn hoá,
culture	nền văn hóa,
cup	tách,
cure	chữa khỏi,
curiosity	sự tò mò,
curious	Hiếu kỳ,
currency	tiền tệ,
current	hiện hành,
currently	hiện tại,
curtain	tấm màn,
curve	đường cong,
custody	quyền nuôi con,
custom	tập quán,
customer	khách hàng,
cut	cắt tỉa,
cute	dễ thương,
dad	cha,
daily	hằng ngày,
dam	con đập,
damage	hư hại,
damn	chỉ trích,
dance	nhảy,
dancer	vũ công,
dancing	khiêu vũ,
danger	nguy hiểm,
dangerous	nguy hiểm,
dare	dám,
dark	tối,
data	dữ liệu,
database	cơ sở dữ liệu,
date	ngày,
daughter	Con gái,
dawn	bình minh,
day	ngày,
dead	đã chết,
deadline	hạn chót,
deadly	chết người,
deal	thỏa thuận,
dear	kính thưa,
death	tử vong,
debate	tranh luận,
debris	mảnh vụn,
debt	món nợ,
debut	ra mắt,
decade	thập kỷ,
decent	phong nha,
decide	quyết định,
decision	phán quyết,
declare	khai,
decorate	trang trí,
decrease	giảm bớt,
dedicate	dâng hiến,
deem	thấy,
deep	sâu,
defeat	đánh bại,
defend	phòng thủ,
defendant	bị cáo,
defender	hậu vệ,
defense	phòng thủ,
define	định nghĩa,
degree	trình độ,
delay	sự chậm trễ,
deliberately	thong thả,
delicate	tinh tế,
delight	Hân hoan,
deliver	giao hàng,
demand	nhu cầu,
democracy	dân chủ,
Democrat	Dân chủ,
democratic	dân chủ,
demographic	nhân khẩu học,
demonstrate	chứng minh,
demonstration	trình diễn,
denial	từ chối,
dense	dày đặc,
density	tỉ trọng,
deny	phủ nhận,
depart	khởi hành,
department	bộ phận,
departure	khởi hành,
depend	tùy theo,
dependent	phụ thuộc,
depict	miêu tả,
deploy	triển khai,
deposit	tiền gửi,
depressed	suy sụp,
derive	lấy được,
descend	hạ xuống,
describe	miêu tả,
design	thiết kế,
desire	khao khát,
desk	bàn,
desperate	tuyệt vọng,
desperately	tuyệt vọng,
despite	mặc dù,
dessert	món tráng miệng,
destination	nơi đến,
destroy	hủy hoại,
detail	chi tiết,
detailed	chi tiết,
detective	thám tử,
determination	sự quyết tâm,
determine	mục đích,
devastating	tàn phá,
develop	phát triển,
developer	nhà phát triển,
development	phát triển,
developmental	phát triển,
device	thiết bị,
devil	ác quỷ,
devote	cống hiến,
diabetes	Bệnh tiểu đường,
diagnose	chẩn đoán,
diagnosis	chẩn đoán,
diamond	kim cương,
diary	Nhật ký,
dictate	điều khiển,
die	chết,
differ	khác nhau,
difference	Sự khác biệt,
different	khác nhau,
differently	khác,
difficult	khó khăn,
difficulty	khó khăn,
dignity	phẩm giá,
dilemma	tình trạng khó xử,
diminish	suy giảm,
dinner	bữa tối,
dip	nhúng,
diplomat	nhà ngoại giao,
diplomatic	ngoại giao,
direct	thẳng thắn,
direction	phương hướng,
directly	trực tiếp,
director	giám đốc,
disabled	tàn tật,
disappear	biến mất,
disappointed	thất vọng,
disappointment	thất vọng,
disc	đĩa,
disclose	tiết lộ,
discount	giảm giá,
discourage	gây chán nản cho,
discourse	đàm luận,
discover	khám phá,
discrimination	kỳ thị,
discuss	bàn luận,
discussion	thảo luận,
disease	dịch bệnh,
dish	món ăn,
disk	đĩa,
dissolve	giải thể,
distance	khoảng cách,
distinct	khác biệt,
distinctive	đặc biệt,
distinguish	phân biệt,
distract	làm mất tập trung,
district	huyện,
disturb	xáo trộn,
disturbing	phiền,
divide	chia,
divine	thần thánh,
division	phân chia,
divorce	ly hôn,
do	làm,
dock	bến tàu,
doctor	Bác sĩ,
doctrine	học thuyết,
document	tài liệu,
documentary	phim tài liệu,
dog	chó,
doll	búp bê,
domain	miền,
domestic	trong nước,
dominant	có ưu thế,
donate	hiến tặng,
donation	Quyên góp,
donor	nhà tài trợ,
door	cửa,
doorway	lối vào,
dose	liều,
dot	dấu chấm,
doubt	nghi ngờ,
dough	bột,
down	xuống,
downtown	trung tâm thành phố,
dozen	tá,
draft	bản nháp,
drain	ráo nước,
dramatically	đột ngột,
draw	vẽ tranh,
drawer	ngăn kéo,
dream	mơ tưởng,
dress	trang phục,
dried	khô,
drift	trôi dạt,
drill	máy khoan,
drink	uống,
drinking	uống,
drive	lái xe,
driver	người lái xe,
driveway	đường lái xe,
driving	điều khiển,
drop	rơi vãi,
drown	chết chìm,
drug	thuốc uống,
drum	trống,
drunk	say,
dry	khô,
duck	con vịt,
due	đến hạn,
dumb	ngớ ngẩn,
dump	đổ,
during	suốt trong,
Dutch	Người Hà Lan,
duty	nhiệm vụ,
dying	chết,
dynamic	năng động,
dynamics	động lực học,
each	mỗi,
eager	hăng hái,
ear	tai,
early	sớm,
earn	kiếm,
earth	trái đất,
earthquake	động đất,
ease	giảm bớt,
easily	dễ dàng,
east	Đông,
eastern	phương Đông,
easy	dễ dàng,
eat	ăn,
eating	Ăn,
echo	echo,
ecological	sinh thái,
economic	thuộc kinh tế,
economically	kinh tế,
economics	Kinh tế học,
economist	nhà kinh tế học,
economy	nên kinh tê,
ecosystem	hệ sinh thái,
edge	cạnh,
edit	chỉnh sửa,
edition	phiên bản,
editor	người biên tập,
educate	giáo dục,
education	giáo dục,
educational	giáo dục,
effect	hiệu ứng,
effective	có hiệu lực,
effectiveness	hiệu quả,
efficiency	hiệu quả,
efficient	hiệu quả,
effort	cố gắng,
egg	trứng,
ego	tự ngã,
eight	tám,
eighth	thứ tám,
either	hoặc,
elaborate	kỹ lưỡng,
elbow	khuỷu tay,
elder	đàn anh,
election	cuộc bầu cử,
electrical	điện,
electronics	thiết bị điện tử,
elegant	thanh lịch,
element	thành phần,
elephant	con voi,
elevator	thang máy,
eleven	mười một,
eligible	hội đủ điều kiện,
eliminate	loại bỏ,
else	khác,
email	email,
embarrassed	xấu hổ,
emerge	hiện ra,
emergency	trường hợp khẩn cấp,
emerging	mới nổi,
emotional	đa cảm,
emotionally	tình cảm,
empire	đế chế,
employ	thuê,
employee	Nhân viên,
empty	trống,
enact	ban hành,
encounter	gặp gỡ,
encourage	khuyến khích,
encouraging	khuyến khích,
end	kết thúc,
endless	bất tận,
endorse	chứng thực,
endure	chịu đựng,
enemy	kẻ thù,
energy	năng lượng,
enforce	thi hành,
engage	thuê,
engagement	hôn ước,
engine	động cơ,
English	Anh,
enjoy	thưởng thức,
enough	đủ,
enroll	ghi danh,
ensure	đảm bảo,
enter	đi vào,
enthusiasm	hăng hái,
entire	toàn bộ,
entirely	hoàn toàn,
entitle	quyền lợi,
entity	thực thể,
entrepreneur	doanh nhân,
envelope	phong bì,
environment	môi trường,
environmental	môi trường,
envision	hình dung,
epidemic	bệnh dịch,
equal	công bằng,
equality	bình đẳng,
equation	phương trình,
equip	Trang bị,
equipment	Trang thiết bị,
equity	công bằng,
equivalent	tương đương,
era	kỷ nguyên,
escape	thoát khỏi,
especially	đặc biệt,
essence	Bản chất,
essential	Cần thiết,
establish	thành lập,
estate	bất động sản,
estimate	ước tính,
estimated	ước tính,
etc	vv,
ethical	đạo đức,
ethics	đạo đức,
ethnic	dân tộc,
European	Châu Âu,
even	cũng,
evening	tối,
event	biến cố,
eventually	cuối cùng,
ever	không bao giờ,
every	mỗi,
everybody	mọi người,
everyday	mỗi ngày,
everyone	tất cả mọi người,
everything	mọi điều,
everywhere	mọi nơi,
evidence	chứng cớ,
evident	hiển nhiên,
evil	tà ác,
exact	chính xác,
exactly	chính xác,
exam	thi,
examination	kiểm tra,
examine	xem xét,
example	thí dụ,
exceed	quá,
except	ngoại trừ,
excessive	quá đáng,
exchange	trao đổi,
excited	bị kích thích,
excitement	sự phấn khích,
exclude	loại trừ,
exclusive	độc quyền,
exclusively	duy nhất,
excuse	tha,
execute	thi hành,
execution	chấp hành,
executive	điều hành,
exercise	tập thể dục,
exhaust	thoát ra,
exhibit	triển lãm,
exist	hiện hữu,
exit	lối thoát,
exotic	kỳ lạ,
expand	mở rộng,
expect	chờ đợi,
expectation	sự mong đợi,
expected	kỳ vọng,
expedition	thám hiểm,
expensive	đắt,
experience	kinh nghiệm,
experienced	có kinh nghiệm,
experimental	thử nghiệm,
expert	chuyên gia,
expertise	chuyên môn,
explain	giải thích,
explicit	rõ ràng,
explode	nổ tung,
exploit	khai thác,
exploration	thăm dò,
explore	khám phá,
explosion	nổ,
export	xuất khẩu,
express	bày tỏ,
expression	biểu hiện,
extend	mở rộng,
extended	mở rộng,
extension	sự mở rộng,
extent	phạm vi,
extra	thêm,
extremely	vô cùng,
eye	mắt,
eyebrow	lông mày,
fabric	vải,
face	đối mặt,
facilitate	tạo điều kiện,
facility	cơ sở,
fact	thực tế,
factor	hệ số,
faculty	giảng viên,
fail	Thất bại,
failure	thất bại,
faint	mờ nhạt,
fair	hội chợ,
faith	đức tin,
fall	ngã,
fame	danh tiếng,
familiar	quen,
family	gia đình,
famous	nổi danh,
fan	quạt,
fantastic	tuyệt diệu,
far	xa,
fare	giá vé,
farm	nông trại,
farmer	nông phu,
fascinating	hấp dẫn,
fashion	thời trang,
fast	Nhanh,
faster	nhanh hơn,
fat	mập,
fatal	gây tử vong,
father	cha,
fatigue	mệt mỏi,
favor	ủng hộ,
favorable	thuận lợi,
favorite	yêu thích,
fear	nỗi sợ,
feather	lông vũ,
feature	đặc tính,
federal	liên bang,
fee	chi phí,
feed	nuôi,
feedback	Phản hồi,
feel	cảm thấy,
feeling	cảm giác,
fellow	đồng bào,
female	giống cái,
feminist	nữ quyền sĩ,
festival	lễ hội,
fever	sốt,
few	vài,
fewer	ít hơn,
field	cánh đồng,
fierce	khốc liệt,
fifteen	mười lăm,
fifty	năm mươi,
fight	chiến đấu,
fighter	đấu sĩ,
fighting	trận đánh,
figure	nhân vật,
file	tập tin,
fill	lấp đầy,
film	phim ảnh,
filter	lọc,
final	sau cùng,
finally	cuối cùng,
finance	tài chính,
financial	tài chính,
find	tìm thấy,
finding	Phát hiện,
fine	khỏe,
finger	ngón tay,
finish	hoàn thành,
fire	ngọn lửa,
firm	chắc chắn,
firmly	vững chắc,
first	Đầu tiên,
fiscal	tài chính,
fish	cá,
fisherman	ngư dân,
fist	nắm tay,
fit	Phù hợp,
fitness	sự tập thể dục,
five	số năm,
fix	sửa chữa,
fixed	đã sửa,
flame	ngọn lửa,
flash	đèn flash,
flavor	hương vị,
fleet	hạm đội,
flesh	xác thịt,
flexibility	Mềm dẻo,
flexible	linh hoạt,
flight	chuyến bay,
flip	lật,
float	phao,
flood	lũ,
floor	sàn nhà,
flour	bột mì,
flow	lưu lượng,
flower	hoa,
fluid	chất lỏng,
fly	bay,
flying	bay,
focus	tiêu điểm,
fog	sương mù,
fold	gập lại,
folk	dân gian,
follow	theo,
following	tiếp theo,
food	món ăn,
fool	ngu xuẩn,
foot	chân,
football	bóng đá,
for	cho,
forbid	ngăn cấm,
force	lực lượng,
forehead	trán,
foreign	ngoại quốc,
foreigner	người nước ngoài,
forest	rừng,
forget	quên,
forgive	tha lỗi,
fork	cái nĩa,
form	hình thức,
format	định dạng,
formation	sự hình thành,
former	trước đây,
formerly	trước kia,
formula	công thức,
forth	ra,
fortunately	may mắn,
forty	bốn mươi,
forum	diễn đàn,
forward	phía trước,
foster	nuôi dưỡng,
four	bốn,
fourth	thứ tư,
fraction	phân số,
fragile	mong manh,
fragment	miếng,
frame	khung,
franchise	nhượng quyền thương mại,
frankly	thẳng thắn,
fraud	gian lận,
free	miễn phí,
freedom	sự tự do,
freely	tự do,
French	người Pháp,
frequency	tần số,
frequent	Thường xuyên,
frequently	thường xuyên,
fresh	tươi,
freshman	sinh viên năm nhất,
friend	người bạn,
friendship	hữu nghị,
from	từ,
front	trước mặt,
frontier	biên giới,
frown	nhăn mặt,
frozen	đông lạnh,
fruit	trái cây,
frustrate	thất vọng,
frustration	thất vọng,
fucking	fucking,
fuel	nhiên liệu,
full	đầy,
fulltime	toàn thời gian,
fully	đầy đủ,
fun	vui vẻ,
function	chức năng,
functional	chức năng,
fund	quỹ,
funny	buồn cười,
fur	lông thú,
furthermore	hơn nữa,
future	Tương lai,
gain	thu được,
galaxy	Thiên hà,
gallery	bộ sưu tập,
game	trò chơi,
garage	gara,
garbage	rác thải,
garden	vườn,
gas	khí đốt,
gasoline	xăng,
gather	tụ họp,
gathering	thu thập,
gaze	nhìn chằm chằm,
gender	giới tính,
general	chung,
generally	nói chung là,
generate	tạo ra,
generation	thế hệ,
generous	hào phóng,
genius	Thiên tài,
genre	thể loại,
gentle	dịu dàng,
genuine	chính hãng,
German	tiếng Đức,
get	được,
ghost	ma,
giant	khổng lồ,
gift	quà tặng,
gifted	năng khiếu,
girl	con gái,
girlfriend	bạn gái,
give	đưa cho,
given	được,
glance	nháy mắt,
glass	ly,
glimpse	nhìn thoáng qua,
global	toàn cầu,
globe	quả địa cầu,
glory	vinh quang,
glove	găng tay,
go	đi,
goal	mục tiêu,
goat	con dê,
God	thần,
gold	vàng,
golden	vàng,
golf	golf,
good	tốt,
govern	quản lý,
government	chính quyền,
governor	thống đốc,
grab	vồ lấy,
grace	ân sủng,
grade	cấp,
graduation	tốt nghiệp,
grain	ngũ cốc,
grandchild	cháu ngoại,
grandparent	ông bà,
grant	ban cho,
grape	giống nho,
grasp	sự hiểu biết,
grateful	tri ân,
grave	phần mộ,
gravity	nghiêm trọng,
gray	màu xám,
great	tuyệt quá,
greatest	vĩ đại nhất,
greatly	rất nhiều,
Greek	người Hy Lạp,
green	màu xanh lá,
greet	chào hỏi,
grief	đau buồn,
grin	nụ cười,
grip	nắm chặt,
grocery	tạp hóa,
gross	Tổng,
ground	đất,
group	nhóm,
grow	lớn lên,
growing	phát triển,
growth	sự phát triển,
guarantee	Bảo hành,
guard	bảo vệ,
guess	phỏng đoán,
guest	khách,
guidance	hướng dẫn,
guide	hướng dẫn,
guideline	hướng dẫn,
guilt	tội lỗi,
guitar	đàn ghi ta,
gun	súng,
gut	ruột,
guy	chàng,
gym	phòng thể dục,
ha	ha,
habitat	môi trường sống,
hair	tóc,
half	một nửa,
halfway	nửa chừng,
hall	đại sảnh,
hallway	hành lang,
hand	tay,
handful	ít,
handle	xử lý,
handsome	đẹp,
hang	treo,
happen	xảy ra,
happily	hạnh phúc,
happiness	hạnh phúc,
happy	vui mừng,
harassment	quấy rối,
hard	cứng,
hardly	khó khăn,
hardware	phần cứng,
harm	làm hại,
harmony	hòa hợp,
harsh	khắc nghiệt,
harvest	mùa gặt,
hate	ghét bỏ,
haul	lôi,
hazard	nguy hiểm,
he	anh ta,
head	cái đầu,
headache	đau đầu,
headline	tiêu đề,
heal	chữa lành,
health	Sức khỏe,
healthy	khỏe mạnh,
hear	Nghe,
hearing	thính giác,
heart	tim,
heat	nhiệt,
heavy	nặng,
heel	gót chân,
helicopter	máy bay trực thăng,
hell	Địa ngục,
helmet	mũ bảo hiểm,
help	Cứu giúp,
helpful	Hữu ích,
hence	vì thế,
her	cô ấy,
herb	thảo mộc,
here	đây,
heritage	gia tài,
hero	anh hùng,
hers	của cô ấy,
herself	cô ấy,
hesitate	do dự,
hey	Chào,
hidden	ẩn,
hide	ẩn giấu,
high	cao,
highlight	Điểm nổi bật,
highly	cao,
hightech	công nghệ cao,
hike	đi lang thang,
him	anh ta,
himself	bản thân anh ấy,
hint	dấu,
hire	thuê mướn,
his	của anh ấy,
Hispanic	Người Hispanic,
historical	lịch sử,
historically	lịch sử,
history	lịch sử,
hit	đánh,
hockey	khúc côn cầu,
hold	giữ,
hole	lỗ,
holiday	ngày lễ,
home	nhà,
homeland	quê hương,
homeless	Vô gia cư,
homework	bài tập về nhà,
honestly	thành thật,
hook	cái móc,
hope	mong,
hopefully	hy vọng,
horizon	đường chân trời,
hormone	hoocmon,
horn	sừng,
horrible	kinh khủng,
horror	kinh dị,
horse	con ngựa,
hospital	bệnh viện,
host	chủ nhà,
hostage	con tin,
hostile	Hostile,
hot	nóng bức,
hotel	khách sạn,
hour	giờ,
house	nhà ở,
household	hộ gia đình,
how	làm sao,
however	Tuy nhiên,
hug	ôm,
huge	khổng lồ,
huh	Huh,
human	Nhân loại,
humanity	nhân loại,
humor	hài hước,
hundred	hàng trăm,
hunger	đói,
hungry	đói bụng,
hunt	săn bắn,
hunter	thợ săn,
hurricane	bão,
hurry	vội,
hurt	đau,
husband	người chồng,
hypothesis	giả thuyết,
I	tôi,
ice	Nước đá,
icon	biểu tượng,
idea	ý kiến,
ideal	lý tưởng,
identical	giống nhau,
identification	nhận biết,
identify	nhận định,
identity	danh tính,
ideological	ý thức hệ,
ideology	hệ tư tưởng,
if	nếu,
ignore	bỏ qua,
illusion	ảo giác,
image	hình ảnh,
imagine	tưởng tượng,
immediately	ngay,
immune	miễn dịch,
impact	va chạm,
implementation	thực hiện,
import	nhập khẩu,
importance	tầm quan trọng,
important	quan trọng,
importantly	quan trọng,
impossible	Không thể nào,
impress	gây ấn tượng,
impressive	ấn tượng,
improve	cải tiến,
improved	cải tiến,
improvement	cải tiến,
impulse	thúc đẩy,
in	trong,
incident	biến cố,
include	bao gồm,
including	kể cả,
income	thu nhập,
increase	tăng,
increasingly	ngày càng,
incredible	đáng kinh ngạc,
incredibly	vô cùng,
indeed	thật,
independent	độc lập,
Indian	người Ấn Độ,
indicate	biểu thị,
indication	dấu hiệu,
indicator	chỉ thị,
indigenous	bản địa,
individual	cá nhân,
industrial	công nghiệp,
industry	ngành công nghiệp,
inevitable	chắc chắn xảy ra,
inevitably	chắc chắn,
infant	trẻ sơ sinh,
inflation	lạm phát,
influence	ảnh hưởng,
influential	có ảnh hưởng,
informal	không chính thức,
information	thông tin,
infrastructure	cơ sở hạ tầng,
inherent	vốn có,
inherit	thừa kế,
initial	ban đầu,
initiate	bắt đầu,
injure	làm bị thương,
injury	chấn thương,
inmate	tù nhân,
innovation	đổi mới,
innovative	sáng tạo,
input	đầu vào,
inquiry	yêu cầu,
insect	côn trùng,
insert	chèn,
inside	phía trong,
insist	năn nỉ,
inspection	kiểm tra,
inspector	thanh tra,
inspiration	cảm hứng,
installation	cài đặt,
instant	tức thời,
instantly	ngay lập tức,
instead	thay thế,
instinct	bản năng,
institution	tổ chức,
institutional	thể chế,
instruct	dạy,
instruction	chỉ dẫn,
instructional	hướng dẫn,
instructor	giảng viên,
instrument	dụng cụ,
insurance	bảo hiểm,
intact	nguyên vẹn,
integrate	tích hợp,
integrated	tích hợp,
integration	hội nhập,
integrity	chính trực,
intellectual	trí tuệ,
intelligence	Sự thông minh,
intelligent	thông minh,
intend	dự định,
intensity	cường độ,
intent	ý định,
interact	tương tác,
interest	quan tâm,
interested	quan tâm,
interesting	hấp dẫn,
interfere	gây trở ngại,
interior	Nội địa,
internal	bên trong,
international	quốc tế,
Internet	Internet,
interrupt	làm gián đoạn,
interval	khoảng thời gian,
intervention	can thiệp,
interview	phỏng vấn,
intimate	thân mật,
into	vào,
introduce	giới thiệu,
invade	xâm chiếm,
invasion	cuộc xâm lăng,
invent	phát minh,
invention	sự phát minh,
inventory	hàng tồn kho,
investigate	điều tra,
investigation	cuộc điều tra,
investment	đầu tư,
investor	nhà đầu tư,
invisible	vô hình,
invitation	lời mời,
invite	mời gọi,
involve	liên quan,
involved	có tính liên quan,
Iraqi	Iraqi,
ironically	trớ trêu thay,
irony	mỉa mai,
Islam	đạo Hồi,
island	Đảo,
isolate	cô lập,
isolated	bị cô lập,
isolation	cô lập,
Israeli	Israeli,
issue	vấn đề,
it	nó,
item	mục,
its	của nó,
itself	chính no,
Japanese	tiếng Nhật,
jar	lọ,
jaw	hàm,
jazz	jazz,
jeans	Quần jean,
jet	máy bay phản lực,
jewelry	đồ trang sức,
Jewish	Người Do thái,
job	việc làm,
join	tham gia,
joke	đùa,
journalism	báo chí,
judge	thẩm phán,
judgment	phán đoán,
judicial	tư pháp,
jump	nhảy,
jungle	rừng nhiệt đới,
jurisdiction	quyền hạn,
juror	bồi thẩm đoàn,
jury	ban bồi thẩm,
just	chỉ,
justice	Sự công bằng,
keep	giữ,
key	Chìa khóa,
kick	đá,
kid	đứa trẻ,
kill	giết chết,
killing	giết chết,
kind	loại,
kingdom	Vương quốc,
kiss	hôn,
kit	bộ dụng cụ,
kitchen	phòng bếp,
knee	đầu gối,
kneel	quỳ xuống,
know	biết,
knowledge	hiểu biết,
known	nổi tiếng,
Korean	Hàn Quốc,
label	nhãn,
labor	lao động,
laboratory	phòng thí nghiệm,
lack	thiếu sót,
ladder	thang,
lady	quý bà,
lamp	đèn,
land	đất đai,
landing	đổ bộ,
landmark	mốc,
landscape	phong cảnh,
lane	lane,
language	ngôn ngữ,
lap	vòng,
large	lớn,
largely	phần lớn,
laser	laser,
last	Cuối cùng,
late	muộn,
lately	gần đây,
later	một lát sau,
laugh	cười,
laughter	tiếng cười,
launch	phóng,
laundry	giặt ủi,
law	pháp luật,
lawmaker	nhà lập pháp,
lawyer	luật sư,
lay	đặt nằm,
lead	chì,
leader	lãnh đạo,
leadership	khả năng lãnh đạo,
leaf	lá,
league	liên đoàn,
lean	nạc,
leap	nhảy vọt,
learn	học hỏi,
learning	học tập,
least	ít nhất,
leave	rời khỏi,
lecture	bài học,
left	trái,
leg	Chân,
legacy	di sản,
legal	hợp pháp,
legally	hợp pháp,
legend	huyền thoại,
legislative	lập pháp,
legislator	nhà lập pháp,
legislature	cơ quan lập pháp,
legitimate	hợp pháp,
lemon	Chanh,
lend	cho vay,
length	chiều dài,
lens	ống kính,
less	ít hơn,
lesson	bài học,
let	để cho,
letter	lá thư,
level	cấp độ,
liability	trách nhiệm pháp lý,
liberal	tự do,
liberty	tự do,
lid	Nắp,
lie	nói dối,
life	đời sống,
lifestyle	lối sống,
lift	thang máy,
light	ánh sáng,
lighting	thắp sáng,
lightly	nhẹ nhàng,
lightning	sét đánh,
like	như,
likelihood	khả năng,
likely	có khả năng,
likewise	tương tự,
limb	chân tay,
limit	giới hạn,
limitation	giới hạn,
limited	giới hạn,
line	hàng,
link	liên kết,
lion	sư tử,
lip	môi,
liquid	chất lỏng,
list	danh sách,
listen	nghe,
listener	người nghe,
literature	văn chương,
little	ít,
live	trực tiếp,
liver	Gan,
living	sống,
loan	tiền vay,
lobby	sảnh đợi,
local	địa phương,
locate	định vị,
location	vị trí,
lock	Khóa,
log	đăng nhập,
logic	logic,
logical	hợp lý,
lonely	cô đơn,
long	Dài,
longterm	dài hạn,
longtime	thời gian dài,
look	nhìn,
loop	vòng lặp,
lose	thua,
loss	mất mát,
lot	nhiều,
lots	rất nhiều,
loud	to tiếng,
love	yêu,
lovely	đáng yêu,
low	thấp,
loyal	trung thành,
loyalty	lòng trung thành,
lunch	Bữa trưa,
lung	phổi,
machine	máy móc,
magazine	tạp chí,
magic	ma thuật,
magnetic	từ tính,
magnitude	độ lớn,
main	chủ yếu,
mainstream	dòng chính,
maintain	duy trì,
maintenance	bảo trì,
major	chính,
majority	đa số,
make	chế tạo,
makeup	trang điểm,
male	Nam giới,
mall	trung tâm mua sắm,
man	Đàn ông,
manage	quản lý,
management	sự quản lý,
manager	giám đốc,
managing	quản lý,
mandate	ủy nhiệm,
manipulate	vận dụng,
manner	cách thức,
mansion	biệt thự,
manual	sổ tay,
manufacturing	chế tạo,
many	nhiều,
map	bản đồ,
marble	đá hoa,
march	tháng Ba,
margin	lề,
marine	biển,
mark	dấu,
marker	đánh dấu,
market	thị trường,
marketplace	thương trường,
marriage	kết hôn,
married	cưới nhau,
marry	kết hôn,
master	bậc thầy,
match	trận đấu,
mate	người bạn đời,
material	vật chất,
math	môn Toán,
mathematics	toán học,
matter	vấn đề,
maximum	tối đa,
may	Tháng Năm,
maybe	có lẽ,
me	tôi,
meal	bữa ăn,
mean	nghĩa là,
meaning	Ý nghĩa,
meaningful	có ý nghĩa,
means	nghĩa là,
meantime	thời gian chờ đợi,
meanwhile	trong khi đó,
measure	đo,
measurement	phép đo,
meat	thịt,
mechanic	thợ cơ khí,
mechanical	cơ khí,
medal	huy chương,
media	phương tiện truyền thông,
medical	Y khoa,
medication	thuốc men,
medicine	dược phẩm,
medium	Trung bình,
meet	gặp,
meeting	gặp gỡ,
melt	tan chảy,
member	hội viên,
membership	thành viên,
memory	ký ức,
mental	tâm thần,
mentally	tinh thần,
mention	đề cập đến,
mentor	người cố vấn,
menu	thực đơn,
merchant	thương gia,
merit	n,
mess	lộn xộn,
message	thông điệp,
metal	kim loại,
metaphor	phép ẩn dụ,
meter	mét,
method	phương pháp,
metropolitan	đô thị,
middle	ở giữa,
middleclass	tầng lớp trung lưu,
midnight	nữa đêm,
midst	giữa,
might	có thể,
migration	di cư,
mild	nhẹ nhàng,
military	quân đội,
mill	cối xay,
million	triệu,
mind	lí trí,
mineral	khoáng sản,
minimal	tối thiểu,
minimize	giảm thiểu,
minimum	tối thiểu,
minister	bộ trưởng,
ministry	Bộ,
minority	thiểu số,
minute	phút,
miracle	phép màu,
mirror	gương,
miss	bỏ lỡ,
missing	mất tích,
mission	sứ mệnh,
missionary	nhà truyền giáo,
mistake	sai lầm,
mix	pha trộn,
mixed	pha trộn,
mobile	di động,
model	mô hình,
moderate	vừa phải,
modern	hiện đại,
modest	khiêm tốn,
modify	sửa đổi,
molecule	phân tử,
mom	mẹ,
moment	chốc lát,
momentum	Đà,
money	tiền bạc,
monitor	giám sát,
monkey	con khỉ,
monster	quái vật,
month	tháng,
monthly	hàng tháng,
monument	tượng đài,
moral	đạo đức,
more	hơn,
morning	buổi sáng,
mortality	tử vong,
mortgage	thế chấp,
most	phần lớn,
mostly	chủ yếu,
mother	mẹ,
motion	chuyển động,
motivate	động viên,
motivation	động lực,
motive	động cơ,
motor	động cơ,
mount	gắn kết,
mountain	núi,
mouse	chuột,
mouth	miệng,
move	di chuyển,
movement	phong trào,
movie	bộ phim,
Mr	Ông,
Mrs	Bà,
Ms	Cô,
much	nhiều,
mud	bùn,
multiple	nhiều,
municipal	thành phố,
murder	giết người,
muscle	cơ bắp,
museum	viện bảo tàng,
mushroom	nấm,
music	Âm nhạc,
Muslim	Hồi giáo,
must	phải,
mutter	lẩm bẩm,
my	tôi,
myself	riêng tôi,
mysterious	huyền bí,
myth	huyền thoại,
nail	móng tay,
naked	trần truồng,
name	Tên,
narrative	tường thuật,
nasty	bẩn thỉu,
nation	quốc gia,
national	Quốc gia,
nationwide	toàn quốc,
native	tự nhiên,
natural	tự nhiên,
nature	thiên nhiên,
naval	hải quân,
near	ở gần,
nearby	gần đó,
nearly	Gần,
neat	khéo léo,
necessarily	nhất thiết,
necessary	cần thiết,
necessity	sự cần thiết,
neck	cái cổ,
need	nhu cầu,
needle	cây kim,
negative	tiêu cực,
neighbor	hàng xóm,
neighborhood	khu vực lân cận,
neighboring	lân cận,
neither	cũng không,
nerve	dây thần kinh,
nest	tổ,
net	mạng lưới,
network	mạng,
neutral	Trung tính,
never	không bao giờ,
new	Mới,
news	Tin tức,
newspaper	báo chí,
next	kế tiếp,
nice	tốt đẹp,
night	đêm,
nightmare	ác mộng,
nine	chín,
no	Không,
nobody	không ai,
nod	gật đầu,
nomination	đề cử,
nominee	ứng cử viên,
none	không ai,
nonetheless	dù sao,
nonprofit	phi lợi nhuận,
noon	trưa,
nor	cũng không,
norm	định mức,
normal	bình thường,
north	Bắc,
northeast	đông bắc,
northern	Phương bắc,
northwest	Tây Bắc,
nose	mũi,
not	không phải,
note	chú thích,
notebook	sổ tay,
nothing	không có gì,
notice	để ý,
notion	khái niệm,
novel	cuốn tiểu thuyết,
now	hiện nay,
nuclear	Nguyên tử,
number	con số,
nurse	y tá,
nut	hạt,
nutrient	chất dinh dưỡng,
oak	cây sồi,
object	vật,
objection	sự phản đối,
obligation	nghĩa vụ,
observe	quan sát,
obstacle	trở ngại,
obtain	đạt được,
obvious	hiển nhiên,
obviously	chắc chắn,
occasional	thỉnh thoảng,
occupation	nghề nghiệp,
occur	xảy ra,
ocean	đại dương,
oclock	giờ,
odds	tỷ lệ,
of	của,
off	tắt,
offender	tội phạm,
offensive	phản cảm,
offer	phục vụ,
offering	chào bán,
office	văn phòng,
officer	nhân viên văn phòng,
official	chính thức,
officially	chính thức,
often	thường xuyên,
oh	Oh,
oil	dầu,
OK	được,
okay	đuợc,
old	cũ,
oldfashioned	Cổ hủ,
Olympics	Thế vận hội,
on	trên,
once	Một lần,
one	một,
onethird	một phần ba,
online	Trực tuyến,
only	chỉ có,
onto	trên,
open	mở,
opening	khai mạc,
openly	cởi mở,
opera	opera,
operate	vận hành,
operating	điều hành,
operation	hoạt động,
operator	nhà điều hành,
opinion	quan điểm,
opportunity	cơ hội,
oppose	phản đối,
opposed	phản đối,
opposition	Sự đối lập,
opt	opt,
optimistic	lạc quan,
option	Tùy chọn,
or	hoặc là,
oral	miệng,
orange	trái cam,
orbit	quỹ đạo,
order	gọi món,
organ	đàn organ,
organic	hữu cơ,
organism	cơ thể,
organization	cơ quan,
organizational	tổ chức,
organize	tổ chức,
organized	tổ chức,
orientation	sự định hướng,
original	nguyên,
other	khác,
others	Khác,
otherwise	nếu không thì,
ought	nên,
our	của chúng ta,
ours	của chúng tôi,
ourselves	chúng ta,
out	ngoài,
outcome	kết quả,
outdoor	ngoài trời,
outer	bên ngoài,
outfit	trang phục,
outlet	đầu ra,
outline	đề cương,
output	đầu ra,
outside	ở ngoài,
outsider	người ngoài,
outstanding	nổi bật,
over	kết thúc,
overall	tổng thể,
overlook	bỏ qua,
overnight	qua đêm,
oversee	giám sát,
overwhelm	quá tải,
overwhelming	áp đảo,
owe	nợ,
own	sở hữu,
owner	chủ nhân,
ownership	sở hữu,
oxygen	ôxy,
package	gói,
pad	tập giấy,
page	trang,
pain	đau đớn,
painful	đau đớn,
paint	Sơn,
painter	họa sĩ,
painting	bức vẽ,
pair	đôi,
palace	cung điện,
Palestinian	Palestine,
palm	lòng bàn tay,
panel	bảng điều khiển,
panic	hoảng loạn,
paper	giấy,
parade	diễu hành,
parent	cha mẹ,
parental	cha mẹ,
parish	giáo xứ,
park	công viên,
part	phần,
partial	một phần,
partially	một phần,
participant	người tham gia,
participate	tham dự,
particle	hạt,
particular	cụ thể,
particularly	đặc biệt,
partner	cộng sự,
party	buổi tiệc,
pass	vượt qua,
passing	đi qua,
past	quá khứ,
pasta	mỳ ống,
pastor	mục sư,
pat	vỗ vỗ,
patch	vá,
patent	bằng sáng chế,
path	con đường,
patience	kiên nhẫn,
patient	bệnh nhân,
patrol	tuần tra,
patron	người bảo trợ,
pattern	mẫu,
pause	tạm ngừng,
pay	trả,
PC	PC,
peace	hòa bình,
peaceful	bình yên,
peanut	đậu phụng,
peasant	nông dân,
peel	lột vỏ,
peer	ngang nhau,
pen	cây bút,
pencil	bút chì,
pension	lương hưu,
people	những người,
pepper	tiêu,
per	mỗi,
perceived	lĩnh hội,
percentage	phần trăm,
perception	nhận thức,
perfect	hoàn hảo,
perform	biểu diễn,
performance	hiệu suất,
performer	người biểu diễn,
perhaps	có lẽ,
period	giai đoạn,
permission	sự cho phép,
permit	cho phép,
Persian	Người Ba Tư,
persist	tồn tại,
person	người,
personal	cá nhân,
perspective	quan điểm,
persuade	truy vấn,
pet	vật nuôi,
philosophical	triết học,
phone	điện thoại,
photo	hình chụp,
photograph	ảnh chụp,
photographer	nhiếp ảnh gia,
photography	nhiếp ảnh,
physical	vật lý,
physically	thể chất,
physics	vật lý,
piano	đàn piano,
pick	chọn,
pickup	nhặt lên,
picture	hình ảnh,
pie	chiếc bánh,
piece	cái,
pig	con lợn,
pile	Đóng cọc,
pill	Viên thuốc,
pillow	cái gối,
pilot	Phi công,
pin	ghim,
pine	cây thông,
pioneer	người tiên phong,
pipe	ống,
pistol	súng lục,
pit	hố,
pitch	sân cỏ,
pitcher	người bình,
pizza	pizza,
place	địa điểm,
placement	vị trí,
plain	trơn,
plaintiff	nguyên đơn,
plan	kế hoạch,
plane	máy bay,
planet	hành tinh,
planner	lập kế hoạch,
plant	thực vật,
plastic	nhựa,
plate	đĩa,
play	chơi,
player	người chơi,
playoff	playoff,
plea	lời bào chữa,
plead	biện hộ,
pleasant	dễ chịu,
please	xin vui lòng,
pleased	vừa lòng,
pleasure	vui lòng,
plunge	lao xuống,
PM	PM,
pocket	bỏ túi,
point	điểm,
poke	xô,
police	cảnh sát,
policeman	cảnh sát,
policy	chính sách,
political	chính trị,
politician	chính trị gia,
politics	chính trị,
poll	thăm dò ý kiến,
pond	ao,
pool	bơi,
poor	nghèo nàn,
pop	nhạc pop,
popular	phổ biến,
popularity	phổ biến,
population	dân số,
porch	hiên nhà,
pork	thịt heo,
portfolio	danh mục đầu tư,
portray	miêu tả,
position	Chức vụ,
positive	tích cực,
possession	chiếm hữu,
possibility	khả năng,
possible	khả thi,
possibly	có thể,
post	bài đăng,
poster	áp phích,
potential	tiềm năng,
pound	pao,
pour	đổ,
powder	bột,
power	quyền lực,
powerful	quyền lực,
practically	thực tế,
practice	thực hành,
practitioner	học viên,
praise	ca ngợi,
preach	rao giảng,
precious	quí,
precise	tóm lược,
predator	người ăn thịt,
predict	tiên đoán,
prediction	dự đoán,
prefer	thích hơn,
preference	sở thích,
pregnancy	mang thai,
preliminary	sơ bộ,
premise	tiền đề,
premium	phí bảo hiểm,
prepare	chuẩn bị,
prescription	đơn thuốc,
presence	sự hiện diện,
present	hiện tại,
presidency	chức tổng thống,
president	chủ tịch,
presidential	tổng thống,
press	nhấn,
pressure	sức ép,
presumably	có lẽ,
pretty	đẹp,
prevail	chiếm ưu thế,
prevent	ngăn chặn,
prevention	Phòng ngừa,
previous	Trước,
price	giá bán,
primary	sơ cấp,
prime	nguyên tố,
principal	hiệu trưởng,
principle	nguyên tắc,
print	in,
prior	trước,
prison	nhà tù,
privacy	riêng tư,
private	riêng tư,
privately	tư nhân,
privilege	đặc quyền,
prize	giải thưởng,
pro	pro,
probably	có lẽ,
problem	vấn đề,
procedure	thủ tục,
process	quá trình,
processing	Chế biến,
processor	bộ vi xử lý,
proclaim	tuyên bố,
produce	sản xuất,
producer	nhà sản xuất,
product	sản phẩm,
production	sản xuất,
productive	có năng suất,
productivity	năng suất,
professional	chuyên nghiệp,
professor	Giáo sư,
profit	lợi nhuận,
profound	thâm thúy,
program	chương trình,
programming	lập trình,
progress	tiến độ,
progressive	cấp tiến,
prohibit	cấm,
project	dự án,
projection	chiếu,
promise	lời hứa,
promising	hứa hẹn,
promote	Quảng bá,
promotion	quảng cáo,
prompt	nhắc nhở,
property	bất động sản,
proportion	tỉ lệ,
proposal	đề nghị,
propose	cầu hôn,
proposed	đề xuất,
prosecution	truy tố,
protect	bảo vệ,
protection	sự bảo vệ,
protective	bảo vệ,
protest	phản đối,
protocol	giao thức,
proud	tự hào,
prove	chứng minh,
provide	cung cấp,
provided	cung cấp,
provider	các nhà cung cấp,
province	tỉnh,
provoke	kích động,
psychologist	nhà tâm lý học,
public	công cộng,
publicity	công khai,
publicly	công khai,
publish	công bố,
publisher	nhà xuất bản,
pull	kéo,
pulse	xung,
pump	máy bơm,
punch	đấm,
punish	trừng phạt,
punishment	hình phạt,
purchase	mua,
purple	màu tím,
purpose	mục đích,
purse	cái ví,
pursue	theo đuổi,
pursuit	theo đuổi,
push	đẩy,
put	đặt,
puzzle	câu đố,
qualify	đủ tiêu chuẩn,
quality	phẩm chất,
quantity	số lượng,
quarter	phần tư,
quarterback	tiền vệ,
queen	nữ hoàng,
quest	nhiệm vụ,
question	câu hỏi,
questionnaire	bảng câu hỏi,
quick	nhanh chóng,
quickly	Mau,
quiet	Yên tĩnh,
quite	khá,
quote	Trích dẫn,
rabbit	Con thỏ,
race	cuộc đua,
racism	chủ nghĩa phân biệt chủng tộc,
rack	giá đỡ,
radar	radar,
radiation	sự bức xạ,
radio	radio,
rage	giận dữ,
rail	đường sắt,
railroad	đường sắt,
rain	mưa,
raise	nâng cao,
rally	biểu tình,
ranch	trang trại,
random	ngẫu nhiên,
range	phạm vi,
rank	cấp,
rape	hãm hiếp,
rapid	nhanh,
rare	hiếm,
rat	con chuột,
rate	tỷ lệ,
rather	hơn,
rating	Xêp hạng,
ratio	tỉ lệ,
rational	hợp lý,
re	lại,
reach	chạm tới,
reaction	phản ứng,
read	đọc,
reader	người đọc,
readily	dễ dàng,
reading	đọc hiểu,
ready	sẳn sàng,
real	thực,
realistic	thực tế,
reality	thực tế,
realize	nhận ra,
really	có thật không,
realm	cảnh giới,
rear	phía sau,
reason	lý do,
rebel	nổi loạn,
rebuild	xây dựng lại,
recall	hồi tưởng,
receive	nhận được,
receiver	người nhận,
recent	gần đây,
recently	gần đây,
reception	tiếp nhận,
recession	suy thoái kinh tế,
recipient	người nhận,
recognize	nhìn nhận,
recommend	giới thiệu,
record	ghi lại,
recording	ghi âm,
recruit	tuyển dụng,
red	đỏ,
reduce	giảm,
refer	tham khảo,
reference	tài liệu tham khảo,
reflect	phản chiếu,
reform	cải cách,
refrigerator	tủ lạnh,
refuge	nơi ẩn náu,
refuse	từ chối,
regain	giành lại,
regard	quan tâm,
regime	chế độ,
region	khu vực,
regional	khu vực,
register	ghi danh,
regret	hối tiếc,
regular	đều đặn,
regulate	quy định,
regulation	Quy định,
regulator	người điều tiết,
regulatory	quy định,
rehabilitation	phục hồi chức năng,
reinforce	củng cố,
relate	liên hệ,
related	liên quan,
relation	quan hệ,
relationship	mối quan hệ,
relative	quan hệ,
relatively	tương đối,
release	giải phóng,
reliability	độ tin cậy,
reliable	đáng tin cậy,
relief	cứu trợ,
relieve	giải tỏa,
religion	tôn giáo,
religious	Tôn giáo,
reluctant	lưỡng lự,
rely	dựa,
remain	vẫn còn,
remark	nhận xét,
remember	nhớ lại,
remind	nhắc lại,
reminder	nhắc nhở,
removal	gỡ bỏ,
remove	tẩy,
render	render,
rent	thuê,
rental	thuê,
repair	sửa,
repeat	nói lại,
repeatedly	nhiều lần,
replace	thay thế,
replacement	thay thế,
report	bài báo cáo,
reportedly	báo cáo,
reporter	phóng viên,
reporting	Báo cáo,
represent	đại diện,
representative	Tiêu biểu,
republic	nước cộng hòa,
republican	nhà nước cộng hòa,
request	yêu cầu,
require	yêu cầu,
required	cần thiết,
requirement	yêu cầu,
rescue	cứu hộ,
research	nghiên cứu,
researcher	nghiên cứu viên,
resemble	giống,
reservation	đặt phòng,
reserve	dự trữ,
residence	nơi cư trú,
resident	cư dân,
residential	nhà ở,
resign	từ chức,
resolution	độ phân giải,
resource	tài nguyên,
respect	sự tôn trọng,
respectively	tương ứng,
respond	trả lời,
response	phản ứng,
responsibility	trách nhiệm,
responsible	chịu trách nhiệm,
rest	nghỉ ngơi,
restaurant	nhà hàng,
restrict	giới hạn,
restriction	sự hạn chế,
result	kết quả,
resume	tiếp tục,
retail	bán lẻ,
retailer	nhà bán lẻ,
retired	nghỉ hưu,
retreat	rút lui,
return	trở về,
reveal	tiết lộ,
revelation	sự mặc khải,
revenue	thu nhập,
reverse	đảo ngược,
review	ôn tập,
revolutionary	cách mạng,
reward	phần thưởng,
rhetoric	Hùng biện,
rhythm	nhịp,
rib	xương sườn,
ribbon	ribbon,
rich	giàu có,
rid	thoát khỏi,
ride	dap xe,
rider	người lái,
ridge	cây rơm,
ridiculous	nực cười,
rifle	súng trường,
right	đúng,
rim	rim,
ring	nhẫn,
riot	bạo loạn,
rip	Yên nghỉ,
rise	tăng lên,
risk	rủi ro,
risky	rủi ro,
ritual	lễ nghi,
rival	đối thủ,
river	con sông,
road	đường,
robot	robot,
rock	đá,
rocket	tên lửa,
rod	gậy,
role	vai trò,
roll	cuộn,
rolling	lăn,
Roman	Roman,
romance	lãng mạn,
romantic	lãng mạn,
room	phòng,
root	nguồn gốc,
rope	dây thừng,
rose	bông hồng,
round	tròn,
route	lộ trình,
routinely	thường,
row	hàng,
royal	hoàng tộc,
rubber	cao su,
ruin	phá hoại,
rule	qui định,
ruling	phán quyết,
rumor	tin đồn,
run	chạy,
runner	người chạy,
running	đang chạy,
rush	vội vã,
Russian	Người Nga,
sack	bao,
sacred	Linh thiêng,
sacrifice	sự hy sinh,
safe	an toàn,
safely	an toàn,
safety	an toàn,
sail	cánh buồm,
sake	lợi ích,
sales	bán hàng,
salmon	cá hồi,
salt	Muối,
same	tương tự,
sample	mẫu vật,
sanction	sự trừng phạt,
sandwich	sandwich,
satisfy	làm vui lòng,
save	tiết kiệm,
say	Nói,
scale	tỉ lệ,
scan	quét,
scandal	vụ bê bối,
scare	sợ hãi,
scary	đáng sợ,
scatter	tiêu tan,
scene	bối cảnh,
scent	hương thơm,
scheme	kế hoạch,
scholarship	học bổng,
school	trường học,
science	khoa học,
scientific	thuộc về khoa học,
scientist	nhà khoa học,
scope	phạm vi,
score	ghi bàn,
scramble	tranh giành,
scratch	vết trầy,
screen	màn,
screening	kiểm tra,
screw	Đinh ốc,
script	kịch bản,
sculpture	điêu khắc,
sea	biển,
seal	niêm phong,
search	Tìm kiếm,
season	Mùa,
seat	ghế,
second	thứ hai,
secondary	thứ hai,
secret	bí mật,
section	phần,
sector	ngành,
secular	thế tục,
secure	đảm bảo,
security	Bảo vệ,
see	xem,
seed	giống,
seek	tìm kiếm,
seem	hình như,
seemingly	có vẻ,
seize	tịch thu,
seldom	ít khi,
select	lựa chọn,
selected	đã chọn,
selfesteem	lòng tự trọng,
sell	bán,
seller	người bán,
seminar	hội thảo,
Senate	Thượng nghị viện,
send	gửi,
senior	cao cấp,
sensation	cảm giác,
sense	giác quan,
sensitivity	nhạy cảm,
sensor	cảm biến,
sentiment	tình cảm,
separate	tách rời,
separation	tách biệt,
sequence	trình tự,
series	loạt,
serious	nghiêm trọng,
seriously	nghiêm túc,
servant	người hầu,
serve	phục vụ,
service	dịch vụ,
serving	phục vụ,
session	phiên họp,
set	bộ,
setting	cài đặt,
settle	ổn định,
seven	bảy,
seventh	thứ bảy,
several	một số,
severely	nghiêm trọng,
sex	tình dục,
sexual	tình dục,
sexuality	tình dục,
sexually	tình dục,
sexy	sexy,
shade	bóng râm,
shadow	bóng,
shake	lắc,
shallow	nông,
shame	xấu hổ,
shape	hình dạng,
share	chia sẻ,
shared	chia sẻ,
shareholder	cổ đông,
shark	cá mập,
sharply	mạnh,
she	chị ấy,
shed	đổ ra,
sheep	cừu,
sheer	tuyệt,
sheet	tấm,
shift	sự thay đổi,
shine	tỏa sáng,
ship	tàu,
shirt	áo sơ mi,
shit	dơ bẩn,
shock	sốc,
shoe	giày,
shoot	bắn,
shop	cửa tiệm,
shore	bờ biển,
short	ngắn,
shortage	sự thiếu,
shorts	quần short,
shortterm	thời gian ngắn,
shot	bắn,
should	Nên,
shoulder	vai,
shove	xô,
show	chỉ,
shower	vòi hoa sen,
shrimp	con tôm,
shrink	co lại,
shrug	nhún vai,
shut	đóng lại,
shuttle	đưa đón,
shy	nhát,
sibling	anh chị em ruột,
sick	đau ốm,
side	bên,
sidewalk	đường đi bộ,
sigh	thở dài,
sight	thị giác,
sign	ký tên,
signal	tín hiệu,
signature	Chữ ký,
significant	có ý nghĩa,
significantly	đáng kể,
silence	khoảng lặng,
silk	lụa,
silly	ngớ ngẩn,
similar	giống,
similarity	sự giống nhau,
simple	đơn giản,
simply	đơn giản,
simultaneously	đồng thời,
sin	tội,
since	kể từ,
sing	hát,
single	Độc thân,
sink	bồn rửa,
sister	em gái,
sit	ngồi,
site	địa điểm,
situation	tình hình,
six	sáu,
sixth	thứ sáu,
size	kích thước,
ski	trượt tuyết,
skill	kỹ năng,
skilled	có kỹ năng,
skin	da,
skip	bỏ qua,
skirt	váy,
skull	sọ,
sky	bầu trời,
slam	sập,
slap	tát,
slavery	chế độ nô lệ,
sleep	ngủ,
sleeve	tay áo,
slice	lát,
slide	trượt,
slight	nhẹ,
slightly	khinh bỉ,
slip	trượt,
slope	dốc,
slot	khe,
slow	chậm,
slowly	chậm rãi,
small	nhỏ bé,
smart	thông minh,
smile	nụ cười,
snake	con rắn,
sneak	sneak,
snow	tuyết,
so	vì thế,
soak	ngâm,
soap	xà bông,
soar	bay lên,
soccer	bóng đá,
social	xã hội,
socially	xã hội,
society	xã hội,
sock	bít tất,
sodium	natri,
sofa	ghế sô pha,
soft	mềm mại,
soften	làm mềm,
softly	nhẹ nhàng,
software	phần mềm,
soil	đất,
soldier	lính,
sole	Duy Nhất,
solely	chỉ,
solution	dung dịch,
solve	giải quyết,
some	một số,
somebody	có ai,
someday	một ngày nào đó,
somehow	bằng cách nào đó,
someone	người nào,
something	cái gì đó,
sometime	thỉnh thoảng,
sometimes	đôi khi,
somewhat	phần nào,
somewhere	một vài nơi,
son	Con trai,
song	bài hát,
soon	Sớm,
sophisticated	tinh vi,
sorry	lấy làm tiếc,
sort	sắp xếp,
soul	Linh hồn,
sound	âm thanh,
soup	Súp,
source	nguồn,
south	miền Nam,
southeast	Đông Nam,
southern	phía Nam,
southwest	tây nam,
sovereignty	chủ quyền,
Soviet	Liên Xô,
space	không gian,
spare	phụ tùng,
spark	tia lửa,
speak	nói,
special	đặc biệt,
specialize	chuyên môn hóa,
specialty	chuyên môn,
species	loài,
specific	riêng,
specifically	đặc biệt,
specify	chỉ định,
spectacular	đẹp mắt,
spectrum	quang phổ,
speculate	suy đoán,
speculation	suy đoán,
speech	phát biểu,
speed	tốc độ,
spell	Đánh vần,
spend	tiêu,
sphere	quả cầu,
spill	tràn,
spine	xương sống,
spirit	tinh thần,
spit	nhổ,
spite	bất bình,
sponsor	nhà tài trợ,
spoon	cái thìa,
sport	môn thể thao,
spot	nơi,
spouse	vợ hoặc chồng,
spray	Xịt nước,
spread	Lan tràn,
spring	mùa xuân,
sprinkle	rắc,
spy	gián điệp,
squad	đội hình,
square	Quảng trường,
stack	cây rơm,
stadium	sân vận động,
staff	cán bộ,
stage	sân khấu,
stance	lập trường,
stand	đứng,
standard	Tiêu chuẩn,
standing	đứng,
star	ngôi sao,
stare	nhìn chằm chằm,
start	khởi đầu,
starter	bắt đầu,
starting	bắt đầu,
state	tiểu bang,
statement	tuyên bố,
station	ga tàu,
statistical	thống kê,
statue	bức tượng,
status	trạng thái,
statute	đạo luật,
stay	ở lại,
steadily	liên tục,
steak	miếng bò hầm,
steal	lấy trộm,
steam	hơi nước,
steep	dốc,
steer	chỉ đạo,
stem	thân cây,
step	bậc thang,
stereotype	khuôn mẫu,
stick	gậy,
stiff	cứng,
still	vẫn,
stimulate	kích thích,
stimulus	kích thích kinh tế,
stir	khuấy,
stock	cổ phần,
stone	Cục đá,
stop	dừng lại,
store	cửa hàng,
storm	bão táp,
story	câu chuyện,
stove	bếp,
straight	thẳng,
straighten	làm thẳng,
strain	sự căng thẳng,
strange	kỳ lạ,
strategy	chiến lược,
straw	Rơm rạ,
streak	streak,
street	đường phố,
strength	sức mạnh,
strengthen	củng cố,
stress	nhấn mạnh,
stretch	căng ra,
strict	nghiêm khắc,
strictly	nghiêm khắc,
strike	đình công,
striking	nổi bật,
strip	dải,
stroke	Cú đánh,
strong	mạnh,
structural	cấu trúc,
structure	kết cấu,
struggle	đấu tranh,
student	sinh viên,
studio	studio,
study	học,
stuff	đồ đạc,
stumble	tình cờ gặp,
style	Phong cách,
subject	môn học,
submit	đệ trình,
subsequent	sau đó,
subsidy	trợ cấp,
substantially	đáng kể,
subtle	tế nhị,
suburb	ngoại ô,
suburban	ngoại ô,
success	sự thành công,
successful	thành công,
successfully	thành công,
such	như là,
suck	hút,
sudden	đột nhiên,
suddenly	đột ngột,
sue	kiện,
suffer	đau khổ,
suffering	đau khổ,
sufficient	đủ,
sugar	đường,
suggest	đề nghị,
suit	bộ đồ,
suitable	thích hợp,
suite	suite,
sum	tổng hợp,
summary	tóm lược,
summer	mùa hè,
summit	hội nghị thượng đỉnh,
sun	mặt trời,
sunlight	ánh sáng mặt trời,
sunny	nắng,
superior	cấp trên,
supermarket	siêu thị,
supervisor	người giám sát,
supplier	nhà cung cấp,
supply	cung cấp,
support	ủng hộ,
supportive	hỗ trợ,
supposed	giả định,
supposedly	được cho là,
Supreme	Tối cao,
sure	chắc chắn rồi,
surface	bề mặt,
surgeon	bác sĩ phẫu thuật,
surgery	phẫu thuật,
surprise	sự ngạc nhiên,
surprised	ngạc nhiên,
surprisingly	thật ngạc nhiên,
surround	vây quanh,
surrounding	xung quanh,
surveillance	giám sát,
survey	khảo sát,
survive	tồn tại,
survivor	người sống sót,
suspect	nghi ngờ,
suspend	đình chỉ,
suspicion	nghi ngờ,
suspicious	nghi ngờ,
sustain	duy trì,
sustainable	bền vững,
swallow	nuốt,
swear	xin thề,
sweat	mồ hôi,
sweater	áo len,
sweet	ngọt,
swell	sưng lên,
swimming	bơi lội,
swing	lung lay,
switch	công tắc điện,
sword	thanh kiếm,
symbolic	tượng trưng,
sympathy	cảm thông,
syndrome	hội chứng,
system	hệ thống,
table	bàn,
tackle	giải quyết,
tactic	chiến thuật,
tag	nhãn,
tail	đuôi,
take	lấy,
talented	có tài,
talk	nói chuyện,
tall	cao,
tank	xe tăng,
tape	băng,
target	Mục tiêu,
task	bài tập,
tax	Thuế,
taxpayer	người nộp thuế,
teach	dạy,
teacher	giáo viên,
teaching	giảng bài,
team	đội,
teammate	đồng đội,
tear	nước mắt,
technician	kỹ thuật viên,
technique	kỹ thuật,
technological	công nghệ,
technology	Công nghệ,
teenage	thiếu niên,
telephone	Điện thoại,
television	tivi,
tell	nói,
temperature	nhiệt độ,
temple	ngôi đền,
temporary	tạm thời,
ten	mười,
tend	có xu hướng,
tendency	khuynh hướng,
tender	đấu thầu,
tennis	quần vợt,
tent	lều,
term	kỳ hạn,
terms	điều kiện,
terrain	địa hình,
terrible	khủng khiếp,
terribly	khủng khiếp,
terrific	khủng khiếp,
terrorist	khủng bố,
test	thử nghiệm,
text	bản văn,
textbook	sách giáo khoa,
texture	kết cấu,
than	hơn,
thank	cảm tạ,
thanks	cảm ơn,
Thanksgiving	Lễ Tạ ơn,
that	cái đó,
theater	rạp hát,
their	họ,
them	họ,
theme	chủ đề,
themselves	bản thân họ,
then	sau đó,
theological	thần học,
theology	thần học,
theoretical	lý thuyết,
theory	lý thuyết,
therapist	nhà trị liệu,
there	ở đó,
thereby	bằng cách ấy,
therefore	vì thế,
these	những,
they	họ,
thick	dày,
thigh	đùi,
thin	gầy,
thing	Điều,
think	suy nghĩ,
thinking	Suy nghĩ,
third	thứ ba,
this	điều này,
thoroughly	triệt để,
those	những,
though	Tuy nhiên,
thought	nghĩ,
thousand	nghìn,
thread	chủ đề,
threat	mối đe dọa,
threaten	hăm dọa,
three	số ba,
threshold	ngưỡng,
thrive	phát đạt,
through	xuyên qua,
throughout	khắp,
throw	ném,
thumb	ngón tay cái,
thus	do đó,
ticket	vé,
tide	thủy triều,
tie	cà vạt,
tight	chặt chẽ,
tighten	thắt chặt,
tightly	chặt chẽ,
tile	ngói,
till	cho đến,
timber	gỗ,
time	thời gian,
timing	thời gian,
tiny	nhỏ bé,
tip	tiền boa,
tired	mệt mỏi,
title	chức vụ,
tobacco	thuốc lá,
today	hôm nay,
toe	ngón chân,
together	cùng với nhau,
toilet	phòng vệ sinh,
tolerance	lòng khoan dung,
tolerate	tha thứ,
toll	số điện thoại,
tomorrow	Ngày mai,
tonight	tối nay,
too	quá,
tool	dụng cụ,
tooth	răng,
top	hàng đầu,
topic	đề tài,
total	toàn bộ,
totally	hoàn toàn,
touch	chạm,
touchdown	đụng,
tough	khó khăn,
tour	chuyến du lịch,
tourism	du lịch,
toward	đối với,
towel	khăn tắm,
town	thị trấn,
toxic	chất độc,
trace	dấu vết,
track	theo dõi,
trade	buôn bán,
trading	thương mại,
tradition	truyền thống,
traditional	truyên thông,
traditionally	theo truyền thống,
traffic	giao thông,
tragic	bi kịch,
trail	đường mòn,
trailer	trailer,
train	xe lửa,
trainer	người huấn luyện,
training	đào tạo,
trait	đặc điểm,
transaction	Giao dịch,
transformation	chuyển đổi,
transit	quá cảnh,
translation	dịch,
transmission	truyền tải,
transmit	chuyển giao,
transport	vận chuyển,
trap	bẩy,
trash	rác,
trauma	chấn thương,
travel	du lịch,
traveler	du khách,
tray	cái mâm,
treasure	kho báu,
treat	đãi,
treatment	điều trị,
tree	cây,
trend	khuynh hướng,
trial	thử nghiệm,
tribal	bộ lạc,
trick	lừa,
trigger	cò súng,
trim	cắt tỉa,
trip	chuyến đi,
triumph	triumph,
troop	quân,
tropical	nhiệt đới,
trouble	rắc rối,
troubled	gặp rắc rối,
truck	xe tải,
TRUE	THẬT,
truly	thực sự,
trunk	Thân cây,
trust	Lòng tin,
truth	sự thật,
try	thử,
Tshirt	Áo thun,
tuck	tuck,
tumor	khối u,
tune	điều chỉnh,
tunnel	đường hầm,
turkey	gà tây,
turn	xoay,
TV	TV,
twelve	mười hai,
twentieth	hai mươi,
twice	hai lần,
twist	xoắn,
two	hai,
twothirds	hai phần ba,
type	kiểu,
typical	điển hình,
ugly	xấu xí,
uh	uh,
ultimately	cuối cùng,
uncertain	không chắc chắn,
uncertainty	tính không chắc chắn,
uncle	Chú,
uncomfortable	khó chịu,
uncover	khám phá,
under	Dưới,
undergo	trải qua,
undergraduate	đại học,
underlying	cơ bản,
undermine	phá hoại,
understand	hiểu không,
understanding	hiểu biết,
undertake	thực hiện,
unemployment	thất nghiệp,
unexpected	bất ngờ,
unfair	không công bằng,
unfold	mở ra,
unhappy	không vui,
uniform	đồng phục,
union	liên hiệp,
unique	độc nhất,
unit	đơn vị,
unite	thống nhất,
United	United,
unity	thống nhất,
university	trường đại học,
unless	trừ khi,
unlike	không giống,
unprecedented	chưa từng có,
until	cho đến,
up	lên,
update	cập nhật,
upon	trên,
upper	phía trên,
upset	buồn bã,
upstairs	tầng trên,
urban	đô thị,
us	chúng tôi,
use	sử dụng,
used	đã sử dụng,
user	người dùng,
usually	thông thường,
utilize	sử dụng,
vaccine	vắcxin,
vacuum	Khoảng chân không,
valid	có hiệu lực,
validity	hiệu lực,
valley	thung lũng,
value	giá trị,
van	van,
vanish	biến mất,
variable	biến,
variety	đa dạng,
various	nhiều,
vast	rộng lớn,
vegetable	rau,
vehicle	phương tiện,
vendor	nhà cung cấp,
venture	liên doanh,
verbal	lời nói,
verdict	bản án,
version	phiên bản,
versus	đấu với,
vertical	theo chiều dọc,
very	rất,
veteran	cựu chiến binh,
victim	nạn nhân,
victory	chiến thắng,
video	video,
view	lượt xem,
village	làng,
violence	bạo lực,
virtual	ảo,
virtue	Đức hạnh,
vision	tầm nhìn,
visit	chuyến thăm,
visitor	khách thăm quan,
vitamin	vitamin,
vocal	tiếng hát,
voice	tiếng nói,
volume	âm lượng,
voluntary	tình nguyện,
volunteer	Tình nguyện,
vote	bỏ phiếu,
voter	cử tri,
voting	bầu cử,
wagon	toa xe,
waist	eo,
wait	chờ đợi,
wake	đánh thức,
walk	đi bộ,
walking	đi dạo,
wall	Tường,
wander	đi lang thang,
want	muốn,
war	chiến tranh,
warehouse	Kho,
warm	ấm áp,
warmth	ấm áp,
warn	cảnh báo,
warrior	chiến binh,
waste	chất thải,
watch	đồng hồ đeo tay,
water	Nước,
wave	làn sóng,
way	đường,
we	chúng tôi,
weaken	làm suy yếu,
weakness	yếu đuối,
wealthy	giàu có,
weapon	vũ khí,
wear	mặc,
weather	thời tiết,
weave	dệt,
web	web,
weed	cỏ dại,
week	tuần,
weekend	ngày cuối tuần,
weekly	hàng tuần,
weight	cân nặng,
weird	kỳ dị,
welcome	chào mừng,
welfare	phúc lợi,
well	tốt,
wellbeing	hạnh phúc,
wellknown	nổi tiếng,
west	hướng Tây,
western	miền Tây,
whale	cá voi,
what	gì,
whatever	bất cứ điều gì,
wheat	lúa mì,
wheelchair	xe lăn,
when	khi nào,
where	Ở đâu,
wherever	ở đâu,
whether	liệu,
which	mà,
while	trong khi,
whip	roi da,
white	trắng,
who	người nào,
whoever	bất cứ ai,
whole	toàn thể,
whom	ai,
whose	có,
why	tại sao,
wide	rộng,
widespread	phổ biến rộng rãi,
widow	Người đàn bà góa,
wife	người vợ,
wild	hoang dã,
wilderness	hoang dã,
wildlife	động vật hoang dã,
will	sẽ,
willing	sẵn lòng,
willingness	sự sẵn lòng,
win	thắng lợi,
wind	gió,
window	cửa sổ,
wine	rượu nho,
wing	canh,
winner	người chiến thắng,
winter	mùa đông,
wise	khôn ngoan,
wish	muốn,
with	với,
withdrawal	thu hồi,
within	bên trong,
without	không có,
witness	nhân chứng,
wolf	chó sói,
woman	đàn bà,
wonder	ngạc nhiên,
wonderful	Tuyệt vời,
wood	gỗ,
word	từ,
work	công việc,
worker	công nhân,
workout	tập thể dục,
workplace	nơi làm việc,
works	công trinh,
workshop	xưởng,
world	thế giới,
worldwide	trên toàn thế giới,
worried	lo lắng,
worry	lo,
worth	giá trị,
would	sẽ,
wound	vết thương,
wow	wow,
wrist	cổ tay,
write	viết,
writer	nhà văn,
writing	viết,
written	bằng văn bản,
wrong	sai rồi,
yard	sân,
yeah	yeah,
year	năm,
yellow	màu vàng,
yes	Vâng,
yesterday	hôm qua,
yet	chưa,
yield	năng suất,
you	bạn,
young	trẻ,
youngster	thiếu niên,
your	của bạn,
yours	của bạn,
yourself	bản thân bạn,
youth	thiếu niên,
zone	vùng,
